"Fecha","Codigo","Concepto","Tipo","Documento","Oficina","Monto","Saldo"
31/01/2025,"001055","11192264-COSTO IVA CASH-PT-099323326900","D","0002464420","AG. NORTE","0.05","66,292.86"
31/01/2025,"001055","11192264-COSTO OPER CASH-PT-099323326900","D","0002464357","AG. NORTE","0.36","66,292.91"
31/01/2025,"001055","11191784-COSTO IVA CASH-PT-099323326900","D","0002465555","AG. NORTE","0.05","66,293.27"
31/01/2025,"001055","11191784-COSTO OPER CASH-PT-099323326900","D","0002464141","AG. NORTE","0.36","66,293.32"
31/01/2025,"001055","11191711-COSTO IVA CASH-PT-099323326900","D","0002463303","AG. NORTE","0.05","66,293.68"
31/01/2025,"001055","11191711-COSTO OPER CASH-PT-099323326900","D","0002463251","AG. NORTE","0.36","66,293.73"
31/01/2025,"001055","11191673-COSTO IVA CASH-PT-099323326900","D","0002463716","AG. NORTE","0.05","66,294.09"
31/01/2025,"001055","11191673-COSTO OPER CASH-PT-099323326900","D","0002463668","AG. NORTE","0.36","66,294.14"
31/01/2025,"001055","11191632-COSTO IVA CASH-PT-099323326900","D","0002462853","AG. NORTE","0.05","66,294.50"
31/01/2025,"001055","11191632-COSTO OPER CASH-PT-099323326900","D","0002461467","AG. NORTE","0.36","66,294.55"
31/01/2025,"001055","11191582-COSTO IVA CASH-PT-099323326900","D","0002461348","AG. NORTE","0.05","66,294.91"
31/01/2025,"001055","11191582-COSTO OPER CASH-PT-099323326900","D","0002462637","AG. NORTE","0.36","66,294.96"
31/01/2025,"001055","11225803-SINOBALSA SA-PT-779 GARCIA RODO","D","0001140747","AG. NORTE","2,498.34","66,295.32"
31/01/2025,"001055","11225810-SINOBALSA SA-PT-780 ORTIZ CESAR","D","0001140527","AG. NORTE","2,165.67","68,793.66"
31/01/2025,"001055","11225784-SINOBALSA SA-PT-KIM DEV ANT 777","D","0001139956","AG. NORTE","1,000.00","70,959.33"
31/01/2025,"001055","11225760-SINOBALSA SA-PT-776 VASCONEZ GL","D","0001140353","AG. NORTE","1,890.09","71,959.33"
31/01/2025,"001055","11225824-SINOBALSA SA-PT-781 VERA PABLO","D","0001138528","AG. NORTE","2,036.17","73,849.42"
31/01/2025,"001055","11225773-SINOBALSA SA-PT-777 MOYAN FERNA","D","0001138314","AG. NORTE","1,890.09","75,885.59"
31/01/2025,"001055","11225791-SINOBALSA SA-PT-778 VERA PABLO","D","0001137221","AG. NORTE","2,125.74","77,775.68"
31/01/2025,"001055","11193067-SINOBALSA SA-PT-KIM DEV LUIS Y","D","0001096283","AG. NORTE","600.00","79,901.42"
30/01/2025,"001055","11192264-SINOBALSA SA-PT-AEROB F15 SALDO","D","0014020150","AG. NORTE","1,320.00","80,501.42"
30/01/2025,"001055","11191632-SINOBALSA SA-PT-LOG F1424 TRANS","D","0014010238","AG. NORTE","1,019.70","81,821.42"
30/01/2025,"001055","11191711-SINOBALSA SA-PT-774 MEDINAJOSE","D","0014010746","AG. NORTE","2,625.16","82,841.12"
30/01/2025,"001055","11191673-SINOBALSA SA-PT-773 ESTRADA KAT","D","0014007628","AG. NORTE","2,131.74","85,466.28"
30/01/2025,"001055","11191784-SINOBALSA SA-PT-775 MEDINAJOSE","D","0014007375","AG. NORTE","3,206.20","87,598.02"
30/01/2025,"001055","11191582-SINOBALSA SA-PT-TURNO 3X40 ZIMU","D","0014010227","AG. NORTE","145.88","90,804.22"
29/01/2025,"001055","11138824-COSTO IVA CASH-PT-099323326900","D","0002267083","AG. NORTE","0.05","90,950.10"
29/01/2025,"001055","11138824-COSTO OPER CASH-PT-099323326900","D","0002265813","AG. NORTE","0.36","90,950.15"
29/01/2025,"001055","11128079-COSTO IVA CASH-PT-099323326900","D","0002266926","AG. NORTE","0.05","90,950.51"
29/01/2025,"001055","11128079-COSTO OPER CASH-PT-099323326900","D","0002265657","AG. NORTE","0.36","90,950.56"
29/01/2025,"001055","11127953-COSTO IVA CASH-PT-099323326900","D","0002265307","AG. NORTE","0.05","90,950.92"
29/01/2025,"001055","11127953-COSTO OPER CASH-PT-099323326900","D","0002265281","AG. NORTE","0.36","90,950.97"
29/01/2025,"001055","11126296-COSTO IVA CASH-PT-099323326900","D","0002265196","AG. NORTE","0.05","90,951.33"
29/01/2025,"001055","11126296-COSTO OPER CASH-PT-099323326900","D","0002264037","AG. NORTE","0.36","90,951.38"
29/01/2025,"001055","11126144-COSTO IVA CASH-PT-099323326900","D","0002263927","AG. NORTE","0.05","90,951.74"
29/01/2025,"001055","11126144-COSTO OPER CASH-PT-099323326900","D","0002263903","AG. NORTE","0.36","90,951.79"
29/01/2025,"001055","11126023-COSTO IVA CASH-PT-099323326900","D","0002264905","AG. NORTE","0.05","90,952.15"
29/01/2025,"001055","11126023-COSTO OPER CASH-PT-099323326900","D","0002263710","AG. NORTE","0.36","90,952.20"
29/01/2025,"001055","11125988-COSTO IVA CASH-PT-099323326900","D","0002264753","AG. NORTE","0.05","90,952.56"
29/01/2025,"001055","11125988-COSTO OPER CASH-PT-099323326900","D","0002264721","AG. NORTE","0.36","90,952.61"
29/01/2025,"001055","11125947-COSTO IVA CASH-PT-099323326900","D","0002263426","AG. NORTE","0.05","90,952.97"
29/01/2025,"001055","11125947-COSTO OPER CASH-PT-099323326900","D","0002263395","AG. NORTE","0.36","90,953.02"
28/01/2025,"001055","11138824-SINOBALSA SA-PT-772 VERA PABLO","D","0033154503","AG. NORTE","2,073.29","90,953.38"
28/01/2025,"001055","11127953-SINOBALSA SA-PT-INTERQUIMEC 28E","D","0017890397","AG. NORTE","2,517.35","93,026.67"
28/01/2025,"001055","11125947-SINOBALSA SA-PT-768 CASTILLO KA","D","0017883870","AG. NORTE","3,175.74","95,544.02"
28/01/2025,"001055","11126144-SINOBALSA SA-PT-771 MEDINAJOSE","D","0017890231","AG. NORTE","3,273.87","98,719.76"
28/01/2025,"001055","11128079-SINOBALSA SA-PT-COMEX 4X4 CERTI","D","0017883713","AG. NORTE","126.36","101,993.63"
28/01/2025,"001055","11126023-SINOBALSA SA-PT-770 GUAMAN MEDA","D","0017889947","AG. NORTE","2,126.75","102,119.99"
28/01/2025,"001055","11125988-SINOBALSA SA-PT-769 MEDINAJOSE","D","0017883489","AG. NORTE","2,397.06","104,246.74"
28/01/2025,"001055","11126296-SINOBALSA SA-PT-TURNO 1X4 0 289","D","0017883441","AG. NORTE","45.21","106,643.80"
28/01/2025,"001055","11090868-COSTO IVA CASH-PT-099323326900","D","0002512683","AG. NORTE","0.05","106,689.01"
28/01/2025,"001055","11090868-COSTO OPER CASH-PT-099323326900","D","0002512641","AG. NORTE","0.36","106,689.06"
28/01/2025,"001055","11090820-COSTO IVA CASH-PT-099323326900","D","0002512488","AG. NORTE","0.05","106,689.42"
28/01/2025,"001055","11090820-COSTO OPER CASH-PT-099323326900","D","0002512443","AG. NORTE","0.36","106,689.47"
28/01/2025,"001055","11090474-COSTO IVA CASH-PT-099323326900","D","0002510375","AG. NORTE","0.05","106,689.83"
28/01/2025,"001055","11090474-COSTO OPER CASH-PT-099323326900","D","0002510328","AG. NORTE","0.36","106,689.88"
28/01/2025,"001055","11090430-COSTO IVA CASH-PT-099323326900","D","0002512142","AG. NORTE","0.05","106,690.24"
28/01/2025,"001055","11090430-COSTO OPER CASH-PT-099323326900","D","0002512066","AG. NORTE","0.36","106,690.29"
28/01/2025,"001055","11090322-COSTO IVA CASH-PT-099323326900","D","0002511893","AG. NORTE","0.05","106,690.65"
28/01/2025,"001055","11090322-COSTO OPER CASH-PT-099323326900","D","0002509834","AG. NORTE","0.36","106,690.70"
28/01/2025,"001055","11077541-COSTO IVA CASH-PT-099323326900","D","0002509157","AG. NORTE","0.05","106,691.06"
28/01/2025,"001055","11077541-COSTO OPER CASH-PT-099323326900","D","0002509104","AG. NORTE","0.36","106,691.11"
28/01/2025,"001055","11077534-COSTO IVA CASH-PT-099323326900","D","0002508954","AG. NORTE","0.05","106,691.47"
28/01/2025,"001055","11077534-COSTO OPER CASH-PT-099323326900","D","0002508902","AG. NORTE","0.36","106,691.52"
27/01/2025,"001045","S06502712CBC01-JIANGSU SINO NEW-GIRO EXT","C","0117006130","AG. NORTE","93,600.00","106,691.88"
27/01/2025,"001055","11090430-SINOBALSA SA-PT-767 MOYAN FERNA","D","0102132186","AG. NORTE","1,236.29","13,091.88"
27/01/2025,"001055","11090322-SINOBALSA SA-PT-765 KUKUSH SHAU","D","0102132157","AG. NORTE","1,647.45","14,328.17"
27/01/2025,"001055","11090868-SINOBALSA SA-PT-KIM DEV ANT 766","D","0102134996","AG. NORTE","1,000.00","15,975.62"
27/01/2025,"001055","11090820-SINOBALSA SA-PT-766 GARCIA RODO","D","0102134924","AG. NORTE","1,280.15","16,975.62"
27/01/2025,"001055","11090474-SINOBALSA SA-PT-KIM DEV ANT 767","D","0102134779","AG. NORTE","1,000.00","18,255.77"
27/01/2025,"001055","11077534-SINOBALSA SA-PT-INSPECC ANTINAR","D","0006846770","AG. NORTE","177.52","19,255.77"
27/01/2025,"001055","11077541-SINOBALSA SA-PT-765  KUKUSH SHA","D","0006838481","AG. NORTE","3,000.00","19,433.29"
27/01/2025,"001331","DB AH PROGRAMADO","D","0003757662","AGENCIA PARA PROCESOS BATCH","1,500.00","22,433.29"
27/01/2025,"001055","11040199-COSTO IVA CASH-PT-099323326900","D","0002057454","AG. NORTE","0.05","23,933.29"
27/01/2025,"001055","11040199-COSTO OPER CASH-PT-099323326900","D","0002055992","AG. NORTE","0.36","23,933.34"
27/01/2025,"001055","11040142-COSTO IVA CASH-PT-099323326900","D","0002055857","AG. NORTE","0.05","23,933.70"
27/01/2025,"001055","11040142-COSTO OPER CASH-PT-099323326900","D","0002055769","AG. NORTE","0.36","23,933.75"
27/01/2025,"001055","11039945-COSTO IVA CASH-PT-099323326900","D","0002055386","AG. NORTE","0.05","23,934.11"
27/01/2025,"001055","11039945-COSTO OPER CASH-PT-099323326900","D","0002055342","AG. NORTE","0.36","23,934.16"
27/01/2025,"001055","11038130-COSTO IVA CASH-PT-099323326900","D","0002055253","AG. NORTE","0.05","23,934.52"
27/01/2025,"001055","11038130-COSTO OPER CASH-PT-099323326900","D","0002055224","AG. NORTE","0.36","23,934.57"
27/01/2025,"001055","11038079-COSTO IVA CASH-PT-099323326900","D","0002053815","AG. NORTE","0.05","23,934.93"
27/01/2025,"001055","11038079-COSTO OPER CASH-PT-099323326900","D","0002053766","AG. NORTE","0.36","23,934.98"
27/01/2025,"001055","11037848-COSTO IVA CASH-PT-099323326900","D","0002055050","AG. NORTE","0.05","23,935.34"
27/01/2025,"001055","11037848-COSTO OPER CASH-PT-099323326900","D","0002055012","AG. NORTE","0.36","23,935.39"
27/01/2025,"001055","11037240-COSTO IVA CASH-PT-099323326900","D","0002054918","AG. NORTE","0.05","23,935.75"
27/01/2025,"001055","11037240-COSTO OPER CASH-PT-099323326900","D","0002054885","AG. NORTE","0.36","23,935.80"
27/01/2025,"001055","11036966-COSTO IVA CASH-PT-099323326900","D","0002053258","AG. NORTE","0.05","23,936.16"
27/01/2025,"001055","11036966-COSTO OPER CASH-PT-099323326900","D","0002053216","AG. NORTE","0.36","23,936.21"
27/01/2025,"001055","11036920-COSTO IVA CASH-PT-099323326900","D","0002054547","AG. NORTE","0.05","23,936.57"
27/01/2025,"001055","11036920-COSTO OPER CASH-PT-099323326900","D","0002054510","AG. NORTE","0.36","23,936.62"
27/01/2025,"001055","11036848-COSTO IVA CASH-PT-099323326900","D","0002052865","AG. NORTE","0.05","23,936.98"
27/01/2025,"001055","11036848-COSTO OPER CASH-PT-099323326900","D","0002054360","AG. NORTE","0.36","23,937.03"
24/01/2025,"001055","11039945-SINOBALSA SA-PT-PORTEO 3X4 0 28","D","0016268807","AG. NORTE","132.05","23,937.39"
24/01/2025,"001055","11040199-SINOBALSA SA-PT-764 VERA PABLO","D","0016268571","AG. NORTE","2,005.55","24,069.44"
24/01/2025,"001055","11040142-SINOBALSA SA-PT-TURNO 1X4 0 289","D","0016274755","AG. NORTE","45.21","26,074.99"
24/01/2025,"001055","11036966-SINOBALSA SA-PT-760 MOYAN FERNA","D","0013844222","AG. NORTE","1,594.74","26,120.20"
24/01/2025,"001055","11037848-SINOBALSA SA-PT-761 VERA PABLO","D","0013850535","AG. NORTE","2,018.64","27,714.94"
24/01/2025,"001055","11038079-SINOBALSA SA-PT-762 GUANMAN MED","D","0013844244","AG. NORTE","1,538.10","29,733.58"
24/01/2025,"001055","11038130-SINOBALSA SA-PT-763 GARCIA RODO","D","0013844197","AG. NORTE","4,571.89","31,271.68"
24/01/2025,"001055","11037240-SINOBALSA SA-PT-KIM DEV 760 MOY","D","0013850251","AG. NORTE","800.00","35,843.57"
24/01/2025,"001055","11036848-SINOBALSA SA-PT-758 ORTIZ CESAR","D","0013844039","AG. NORTE","1,917.87","36,643.57"
24/01/2025,"001055","11036920-SINOBALSA SA-PT-759 MEDINAJOSE","D","0013843812","AG. NORTE","2,538.39","38,561.44"
24/01/2025,"001055","11002307-COSTO IVA CASH-PT-099323326900","D","0002204726","AG. NORTE","0.05","41,099.83"
24/01/2025,"001055","11002307-COSTO OPER CASH-PT-099323326900","D","0002204696","AG. NORTE","0.36","41,099.88"
24/01/2025,"001055","11002303-COSTO IVA CASH-PT-099323326900","D","0002204571","AG. NORTE","0.05","41,100.24"
24/01/2025,"001055","11002303-COSTO OPER CASH-PT-099323326900","D","0002204553","AG. NORTE","0.36","41,100.29"
24/01/2025,"001055","11002302-COSTO IVA CASH-PT-099323326900","D","0002203117","AG. NORTE","0.05","41,100.65"
24/01/2025,"001055","11002302-COSTO OPER CASH-PT-099323326900","D","0002203096","AG. NORTE","0.36","41,100.70"
24/01/2025,"001055","11001303-COSTO IVA CASH-PT-099323326900","D","0002202997","AG. NORTE","0.05","41,101.06"
24/01/2025,"001055","11001303-COSTO OPER CASH-PT-099323326900","D","0002202969","AG. NORTE","0.36","41,101.11"
24/01/2025,"001055","11001289-COSTO IVA CASH-PT-099323326900","D","0002202859","AG. NORTE","0.05","41,101.47"
24/01/2025,"001055","11001289-COSTO OPER CASH-PT-099323326900","D","0002204159","AG. NORTE","0.36","41,101.52"
24/01/2025,"001055","11001273-COSTO IVA CASH-PT-099323326900","D","0002204060","AG. NORTE","0.05","41,101.88"
24/01/2025,"001055","11001273-COSTO OPER CASH-PT-099323326900","D","0002202687","AG. NORTE","0.36","41,101.93"
24/01/2025,"001055","11001218-COSTO IVA CASH-PT-099323326900","D","0002203905","AG. NORTE","0.05","41,102.29"
24/01/2025,"001055","11001218-COSTO OPER CASH-PT-099323326900","D","0002202562","AG. NORTE","0.36","41,102.34"
24/01/2025,"001055","11001185-COSTO IVA CASH-PT-099323326900","D","0002203807","AG. NORTE","0.05","41,102.70"
24/01/2025,"001055","11001185-COSTO OPER CASH-PT-099323326900","D","0002202458","AG. NORTE","0.36","41,102.75"
24/01/2025,"001055","11001077-COSTO IVA CASH-PT-099323326900","D","0002202275","AG. NORTE","0.05","41,103.11"
24/01/2025,"001055","11001077-COSTO OPER CASH-PT-099323326900","D","0002203547","AG. NORTE","0.36","41,103.16"
24/01/2025,"001055","11001074-COSTO IVA CASH-PT-099323326900","D","0002202121","AG. NORTE","0.05","41,103.52"
24/01/2025,"001055","11001074-COSTO OPER CASH-PT-099323326900","D","0002202094","AG. NORTE","0.36","41,103.57"
23/01/2025,"001365","RETENCION JUDICIAL TRANSITO GUAYAS ATM","D","0057146057","GUAYAQUIL TORRES PICHINCHA","144.90","41,103.93"
23/01/2025,"001055","11002302-SINOBALSA SA-PT-SALDO FACTURA C","D","0002906648","AG. NORTE","22.92","41,248.83"
23/01/2025,"001055","11002303-SINOBALSA SA-PT-SALDO FACTURA C","D","0002895473","AG. NORTE","45.84","41,271.75"
23/01/2025,"001055","11002307-SINOBALSA SA-PT-MARGL F10035813","D","0002896134","AG. NORTE","2,984.09","41,317.59"
23/01/2025,"001055","11001185-SINOBALSA SA-PT-746 LOPEZ DANNY","D","0001631842","AG. NORTE","1,073.03","44,301.68"
23/01/2025,"001055","11001273-SINOBALSA SA-PT-755 GUAMAN MEDA","D","0001632839","AG. NORTE","1,776.34","45,374.71"
23/01/2025,"001055","11001077-SINOBALSA SA-PT-LOG F1394 4X4 0","D","0001623581","AG. NORTE","1,019.70","47,151.05"
23/01/2025,"001055","11001303-SINOBALSA SA-PT-757 MORALES HEN","D","0001622693","AG. NORTE","1,917.34","48,170.75"
23/01/2025,"001055","11001289-SINOBALSA SA-PT-756 LOPEZ DANNY","D","0001623488","AG. NORTE","1,046.54","50,088.09"
23/01/2025,"001055","11001218-SINOBALSA SA-PT-750 KUKUSH SHAU","D","0001623459","AG. NORTE","1,274.68","51,134.63"
23/01/2025,"001055","11001074-SINOBALSA SA-PT-TIBA F22315F223","D","0001623451","AG. NORTE","1,249.84","52,409.31"
22/01/2025,"001045","TRANSFERENCIA INTERBANCARIA RECIBIDA","C","0031378984","CENTRO SERVIC. OPERAT. SS. QTO","4,140.40","53,659.15"
22/01/2025,"001055","10944912-COSTO IVA CASH-PT-099323326900","D","0002390149","AG. NORTE","0.05","49,518.75"
22/01/2025,"001055","10944912-COSTO OPER CASH-PT-099323326900","D","0002390963","AG. NORTE","0.36","49,518.80"
22/01/2025,"001055","10944859-COSTO IVA CASH-PT-099323326900","D","0002388464","AG. NORTE","0.05","49,519.16"
22/01/2025,"001055","10944859-COSTO OPER CASH-PT-099323326900","D","0002388429","AG. NORTE","0.36","49,519.21"
22/01/2025,"001055","10944526-COSTO IVA CASH-PT-099323326900","D","0002389656","AG. NORTE","0.05","49,519.57"
22/01/2025,"001055","10944526-COSTO OPER CASH-PT-099323326900","D","0002389604","AG. NORTE","0.36","49,519.62"
22/01/2025,"001055","10944316-COSTO IVA CASH-PT-099323326900","D","0002389431","AG. NORTE","0.05","49,519.98"
22/01/2025,"001055","10944316-COSTO OPER CASH-PT-099323326900","D","0002387970","AG. NORTE","0.36","49,520.03"
22/01/2025,"001055","10944261-COSTO IVA CASH-PT-099323326900","D","0002387707","AG. NORTE","0.05","49,520.39"
22/01/2025,"001055","10944261-COSTO OPER CASH-PT-099323326900","D","0002389040","AG. NORTE","0.36","49,520.44"
22/01/2025,"001055","10944175-COSTO IVA CASH-PT-099323326900","D","0002387480","AG. NORTE","0.05","49,520.80"
22/01/2025,"001055","10944175-COSTO OPER CASH-PT-099323326900","D","0002387449","AG. NORTE","0.36","49,520.85"
22/01/2025,"001055","10935738-COSTO IVA CASH-PT-099323326900","D","0002387241","AG. NORTE","0.05","49,521.21"
22/01/2025,"001055","10935738-COSTO OPER CASH-PT-099323326900","D","0002388547","AG. NORTE","0.36","49,521.26"
22/01/2025,"001055","10935698-COSTO IVA CASH-PT-099323326900","D","0002386236","AG. NORTE","0.05","49,521.62"
22/01/2025,"001055","10935698-COSTO OPER CASH-PT-099323326900","D","0002386939","AG. NORTE","0.36","49,521.67"
22/01/2025,"001055","10935687-COSTO IVA CASH-PT-099323326900","D","0002386025","AG. NORTE","0.05","49,522.03"
22/01/2025,"001055","10935687-COSTO OPER CASH-PT-099323326900","D","0002385965","AG. NORTE","0.36","49,522.08"
22/01/2025,"001055","10935615-COSTO IVA CASH-PT-099323326900","D","0002386521","AG. NORTE","0.05","49,522.44"
22/01/2025,"001055","10935615-COSTO OPER CASH-PT-099323326900","D","0002385742","AG. NORTE","0.36","49,522.49"
22/01/2025,"001055","10935571-COSTO IVA CASH-PT-099323326900","D","0002384070","AG. NORTE","0.05","49,522.85"
22/01/2025,"001055","10935571-COSTO OPER CASH-PT-099323326900","D","0002385516","AG. NORTE","0.36","49,522.90"
22/01/2025,"001055","10935499-COSTO IVA CASH-PT-099323326900","D","0002383853","AG. NORTE","0.05","49,523.26"
22/01/2025,"001055","10935499-COSTO OPER CASH-PT-099323326900","D","0002383796","AG. NORTE","0.36","49,523.31"
22/01/2025,"001055","10935295-COSTO IVA CASH-PT-099323326900","D","0002385096","AG. NORTE","0.05","49,523.67"
22/01/2025,"001055","10935295-COSTO OPER CASH-PT-099323326900","D","0002383563","AG. NORTE","0.36","49,523.72"
21/01/2025,"001055","COBRO INTERBANCARIO RECIBIDO","D","0027151245","CENTRO SERVIC. OPERAT. SS. QTO","3,428.85","49,524.08"
21/01/2025,"001055","COBRO INTERBANCARIO RECIBIDO IVA","D","0027151245","CENTRO SERVIC. OPERAT. SS. QTO","0.03","52,952.93"
21/01/2025,"001055","COBRO INTERBANCARIO RECIBIDO COMISION","D","0027151245","CENTRO SERVIC. OPERAT. SS. QTO","0.20","52,952.96"
21/01/2025,"001055","COBRO INTERBANCARIO RECIBIDO","D","0027124904","CENTRO SERVIC. OPERAT. SS. QTO","1,850.18","52,953.16"
21/01/2025,"001055","COBRO INTERBANCARIO RECIBIDO IVA","D","0027124904","CENTRO SERVIC. OPERAT. SS. QTO","0.03","54,803.34"
21/01/2025,"001055","COBRO INTERBANCARIO RECIBIDO COMISION","D","0027124904","CENTRO SERVIC. OPERAT. SS. QTO","0.20","54,803.37"
21/01/2025,"001055","10944912-SINOBALSA SA-PT-SANCHEZ DANNY C","D","0020746813","AG. NORTE","18,900.00","54,803.57"
21/01/2025,"001055","10944859-SINOBALSA SA-PT-SANCHEZ DANNY C","D","0020744548","AG. NORTE","20,000.00","73,703.57"
21/01/2025,"001055","10944526-SINOBALSA SA-PT-754 VERA PABLO","D","0017504834","AG. NORTE","2,031.03","93,703.57"
21/01/2025,"001055","10944261-SINOBALSA SA-PT-752 MEDINAJOSE","D","0017413229","AG. NORTE","2,580.87","95,734.60"
21/01/2025,"001055","10944316-SINOBALSA SA-PT-753 MEDINAJOSE","D","0017413256","AG. NORTE","2,624.26","98,315.47"
21/01/2025,"001055","10935295-SINOBALSA SA-PT-MULTAS GSF4669","D","0017413222","AG. NORTE","4,140.40","100,939.73"
21/01/2025,"001055","10944175-SINOBALSA SA-PT-751 MEDINAJOSE","D","0017418067","AG. NORTE","1,132.91","105,080.13"
21/01/2025,"001055","10883887-COSTO IVA CASH-PT-099323326900","D","0002696776","AG. NORTE","0.05","106,213.04"
21/01/2025,"001055","10883887-COSTO OPER CASH-PT-099323326900","D","0002696728","AG. NORTE","0.36","106,213.09"
21/01/2025,"001055","10935698-SINOBALSA SA-PT-749 ROBLES SAND","D","0000940440","AG. NORTE","1,587.26","106,213.45"
21/01/2025,"001055","10935687-SINOBALSA SA-PT-748 MEDINAJOSE","D","0000941074","AG. NORTE","2,120.22","107,800.71"
21/01/2025,"001055","10935499-SINOBALSA SA-PT-744 CUJILAN JOS","D","0000939718","AG. NORTE","2,766.37","109,920.93"
21/01/2025,"001055","10935738-SINOBALSA SA-PT-750  KUKUSH SHA","D","0000938663","AG. NORTE","3,000.00","112,687.30"
21/01/2025,"001055","10935615-SINOBALSA SA-PT-747 VERA PABLO","D","0000939189","AG. NORTE","1,998.42","115,687.30"
21/01/2025,"001055","10935571-SINOBALSA SA-PT-745 MOYAN FERNA","D","0000938266","AG. NORTE","1,869.67","117,685.72"
20/01/2025,"001055","10883765-COSTO IVA CASH-PT-099323326900","D","0058941524","AG. NORTE","0.05","119,555.39"
20/01/2025,"001055","10883765-COSTO OPER CASH-PT-099323326900","D","0058941501","AG. NORTE","0.36","119,555.44"
20/01/2025,"001055","10883592-COSTO IVA CASH-PT-099323326900","D","0058942061","AG. NORTE","0.05","119,555.80"
20/01/2025,"001055","10883592-COSTO OPER CASH-PT-099323326900","D","0058942036","AG. NORTE","0.36","119,555.85"
20/01/2025,"001055","10883532-COSTO IVA CASH-PT-099323326900","D","0058941310","AG. NORTE","0.05","119,556.21"
20/01/2025,"001055","10883532-COSTO OPER CASH-PT-099323326900","D","0058940885","AG. NORTE","0.36","119,556.26"
20/01/2025,"001055","10883273-COSTO IVA CASH-PT-099323326900","D","0058941189","AG. NORTE","0.05","119,556.62"
20/01/2025,"001055","10883273-COSTO OPER CASH-PT-099323326900","D","0058941174","AG. NORTE","0.36","119,556.67"
20/01/2025,"001055","10853848-COSTO IVA CASH-PT-099323326900","D","0058941016","AG. NORTE","0.05","119,557.03"
20/01/2025,"001055","10853848-COSTO OPER CASH-PT-099323326900","D","0058940992","AG. NORTE","0.36","119,557.08"
20/01/2025,"001055","10853792-COSTO IVA CASH-PT-099323326900","D","0058940526","AG. NORTE","2.83","119,557.44"
20/01/2025,"001055","10853792-COSTO OPER CASH-PT-099323326900","D","0058940506","AG. NORTE","18.90","119,560.27"
20/01/2025,"001055","10853792-COSTO IVA CASH-PT-099323326900","D","0058940483","AG. NORTE","0.96","119,579.17"
20/01/2025,"001055","10853792-COSTO OPER CASH-PT-099323326900","D","0058939851","AG. NORTE","6.42","119,580.13"
20/01/2025,"001055","10853696-COSTO IVA CASH-PT-099323326900","D","0058939794","AG. NORTE","0.05","119,586.55"
20/01/2025,"001055","10853696-COSTO OPER CASH-PT-099323326900","D","0058939777","AG. NORTE","0.36","119,586.60"
20/01/2025,"001055","10853696-COSTO IVA CASH-PT-099323326900","D","0058939699","AG. NORTE","0.11","119,586.96"
20/01/2025,"001055","10853696-COSTO OPER CASH-PT-099323326900","D","0058939679","AG. NORTE","0.71","119,587.07"
17/01/2025,"001055","10883887-SINOBALSA SA-PT-C017 CUJILAN JO","D","0049289118","AG. NORTE","900.90","119,587.78"
17/01/2025,"001055","10883273-SINOBALSA SA-PT-740 GUAMAN MEDA","D","0049290799","AG. NORTE","2,060.01","120,488.68"
17/01/2025,"001055","10883592-SINOBALSA SA-PT-742 LOPEZ DANNY","D","0049287946","AG. NORTE","1,099.04","122,548.69"
17/01/2025,"001055","10883765-SINOBALSA SA-PT-743 VERA PABLOF","D","0049287779","AG. NORTE","2,014.19","123,647.73"
17/01/2025,"001055","10883532-SINOBALSA SA-PT-741 GARCIA RODO","D","0049282441","AG. NORTE","3,923.00","125,661.92"
17/01/2025,"001055","10853848-SINOBALSA SA-PT-CERTIFICADOS CO","D","0017624691","AG. NORTE","221.13","129,584.92"
17/01/2025,"001055","10853792-SINOBALSA SA-PT-ROL ENER152025","D","0017608708","AG. NORTE","19,723.00","129,806.05"
17/01/2025,"001055","10853696-SINOBALSA SA-PT-3TRAB FABRICA E","D","0017608671","AG. NORTE","750.00","149,529.05"
17/01/2025,"001055","10829862-COSTO IVA CASH-PT-099323326900","D","0002584397","AG. NORTE","0.05","150,279.05"
17/01/2025,"001055","10829862-COSTO OPER CASH-PT-099323326900","D","0002584284","AG. NORTE","0.36","150,279.10"
17/01/2025,"001055","10829709-COSTO IVA CASH-PT-099323326900","D","0002582750","AG. NORTE","0.05","150,279.46"
17/01/2025,"001055","10829709-COSTO OPER CASH-PT-099323326900","D","0002582698","AG. NORTE","0.36","150,279.51"
17/01/2025,"001055","10828557-COSTO IVA CASH-PT-099323326900","D","0002583947","AG. NORTE","0.05","150,279.87"
17/01/2025,"001055","10828557-COSTO OPER CASH-PT-099323326900","D","0002582596","AG. NORTE","0.36","150,279.92"
17/01/2025,"001055","10828519-COSTO IVA CASH-PT-099323326900","D","0002582500","AG. NORTE","0.05","150,280.28"
17/01/2025,"001055","10828519-COSTO OPER CASH-PT-099323326900","D","0002583823","AG. NORTE","0.36","150,280.33"
17/01/2025,"001055","10828481-COSTO IVA CASH-PT-099323326900","D","0002582382","AG. NORTE","0.05","150,280.69"
17/01/2025,"001055","10828481-COSTO OPER CASH-PT-099323326900","D","0002583705","AG. NORTE","0.36","150,280.74"
16/01/2025,"001055","10829709-SINOBALSA SA-PT-738 ORTIZ CESAR","D","0029472950","AG. NORTE","1,991.56","150,281.10"
16/01/2025,"001055","10829862-SINOBALSA SA-PT-739 ESTRADA KAT","D","0029472889","AG. NORTE","1,881.52","152,272.66"
16/01/2025,"001055","10828557-SINOBALSA SA-PT-TURNOS TERCON 6","D","0028866480","AG. NORTE","271.26","154,154.18"
16/01/2025,"001055","10828481-SINOBALSA SA-PT-737 VERA PABLO","D","0028872232","AG. NORTE","1,625.10","154,425.44"
16/01/2025,"001055","10828519-SINOBALSA SA-PT-PORTEO 6X4 0 28","D","0028865951","AG. NORTE","792.61","156,050.54"
15/01/2025,"001055","10756338-COSTO IVA CASH-PT-099323326900","D","0002540466","AG. NORTE","0.05","156,843.15"
15/01/2025,"001055","10756338-COSTO OPER CASH-PT-099323326900","D","0002541186","AG. NORTE","0.36","156,843.20"
15/01/2025,"001055","10755748-COSTO IVA CASH-PT-099323326900","D","0002540239","AG. NORTE","0.05","156,843.56"
15/01/2025,"001055","10755748-COSTO OPER CASH-PT-099323326900","D","0002540931","AG. NORTE","0.36","156,843.61"
15/01/2025,"001055","10754533-COSTO IVA CASH-PT-099323326900","D","0002540026","AG. NORTE","0.05","156,843.97"
15/01/2025,"001055","10754533-COSTO OPER CASH-PT-099323326900","D","0002539115","AG. NORTE","0.36","156,844.02"
15/01/2025,"001055","10754378-COSTO IVA CASH-PT-099323326900","D","0002538999","AG. NORTE","0.05","156,844.38"
15/01/2025,"001055","10754378-COSTO OPER CASH-PT-099323326900","D","0002539857","AG. NORTE","0.36","156,844.43"
15/01/2025,"001055","10754249-COSTO IVA CASH-PT-099323326900","D","0002538873","AG. NORTE","0.05","156,844.79"
15/01/2025,"001055","10754249-COSTO OPER CASH-PT-099323326900","D","0002539723","AG. NORTE","0.36","156,844.84"
15/01/2025,"001055","10754178-COSTO IVA CASH-PT-099323326900","D","0002539643","AG. NORTE","0.05","156,845.20"
15/01/2025,"001055","10754178-COSTO OPER CASH-PT-099323326900","D","0002539595","AG. NORTE","0.36","156,845.25"
15/01/2025,"001055","10754116-COSTO IVA CASH-PT-099323326900","D","0002539533","AG. NORTE","0.05","156,845.61"
15/01/2025,"001055","10754116-COSTO OPER CASH-PT-099323326900","D","0002538588","AG. NORTE","0.36","156,845.66"
14/01/2025,"001055","10754249-SINOBALSA SA-PT-735 ROBLES SAND","D","0042169083","AG. NORTE","1,470.91","156,846.02"
14/01/2025,"001055","10755748-SINOBALSA SA-PT-INTERQUIMEC 14E","D","0042058708","AG. NORTE","5,034.70","158,316.93"
14/01/2025,"001055","10754533-SINOBALSA SA-PT-LOGIC F1377 TRA","D","0042063093","AG. NORTE","2,435.40","163,351.63"
14/01/2025,"001055","10756338-SINOBALSA SA-PT-KIM PGO PRESTAM","D","0042062871","AG. NORTE","2,000.00","165,787.03"
14/01/2025,"001055","10754378-SINOBALSA SA-PT-736 CHICHANDE A","D","0042058217","AG. NORTE","753.46","167,787.03"
14/01/2025,"001055","10754178-SINOBALSA SA-PT-734 CHICHANDE A","D","0042062336","AG. NORTE","2,803.79","168,540.49"
14/01/2025,"001055","10754116-SINOBALSA SA-PT-733 VERA PABLO","D","0042057730","AG. NORTE","1,778.98","171,344.28"
14/01/2025,"001055","10710581-COSTO IVA CASH-PT-099323326900","D","0003139173","AG. NORTE","0.05","173,123.26"
14/01/2025,"001055","10710581-COSTO OPER CASH-PT-099323326900","D","0003139095","AG. NORTE","0.36","173,123.31"
14/01/2025,"001055","10708688-COSTO IVA CASH-PT-099323326900","D","0003138909","AG. NORTE","0.05","173,123.67"
14/01/2025,"001055","10708688-COSTO OPER CASH-PT-099323326900","D","0003141185","AG. NORTE","0.36","173,123.72"
14/01/2025,"001055","10708594-COSTO IVA CASH-PT-099323326900","D","0003138548","AG. NORTE","0.05","173,124.08"
14/01/2025,"001055","10708594-COSTO OPER CASH-PT-099323326900","D","0003140849","AG. NORTE","0.36","173,124.13"
14/01/2025,"001055","10708483-COSTO IVA CASH-PT-099323326900","D","0003140530","AG. NORTE","0.05","173,124.49"
14/01/2025,"001055","10708483-COSTO OPER CASH-PT-099323326900","D","0003138108","AG. NORTE","0.36","173,124.54"
14/01/2025,"001055","10708428-COSTO IVA CASH-PT-099323326900","D","0003140181","AG. NORTE","0.05","173,124.90"
14/01/2025,"001055","10708428-COSTO OPER CASH-PT-099323326900","D","0003137762","AG. NORTE","0.36","173,124.95"
14/01/2025,"001055","10708350-COSTO IVA CASH-PT-099323326900","D","0003137507","AG. NORTE","0.05","173,125.31"
14/01/2025,"001055","10708350-COSTO OPER CASH-PT-099323326900","D","0003139756","AG. NORTE","0.36","173,125.36"
14/01/2025,"001055","10708276-COSTO IVA CASH-PT-099323326900","D","0003139479","AG. NORTE","0.05","173,125.72"
14/01/2025,"001055","10708276-COSTO OPER CASH-PT-099323326900","D","0003139405","AG. NORTE","0.36","173,125.77"
13/01/2025,"001055","10710581-SINOBALSA SA-PT-TUVAL F250851","D","0123454809","AG. NORTE","188.14","173,126.13"
13/01/2025,"001055","10708350-SINOBALSA SA-PT-728 VERA PABLOF","D","0123453775","AG. NORTE","1,886.55","173,314.27"
13/01/2025,"001055","10708688-SINOBALSA SA-PT-PORTEO 2X40 ZIM","D","0123452705","AG. NORTE","284.53","175,200.82"
13/01/2025,"001055","10708276-SINOBALSA SA-PT-726 TORRES CARL","D","0123452583","AG. NORTE","1,944.67","175,485.35"
13/01/2025,"001055","10708428-SINOBALSA SA-PT-729 CUJILAN JOS","D","0123452556","AG. NORTE","2,506.44","177,430.02"
13/01/2025,"001055","10708483-SINOBALSA SA-PT-730 CUJILAN JOS","D","0123452432","AG. NORTE","2,217.66","179,936.46"
13/01/2025,"001055","10708594-SINOBALSA SA-PT-731 CUJILAN JOS","D","0123453746","AG. NORTE","2,036.65","182,154.12"
13/01/2025,"001055","10645631-COSTO IVA CASH-PT-099323326900","D","0002303725","AG. NORTE","0.05","184,190.77"
13/01/2025,"001055","10645631-COSTO OPER CASH-PT-099323326900","D","0002303688","AG. NORTE","0.36","184,190.82"
10/01/2025,"001055","10645631-SINOBALSA SA-PT-TURNO 2X40 ZIMU","D","0022562356","AG. NORTE","97.24","184,191.18"
10/01/2025,"001045","S0650100D34B01-JIANGSU SINO NEW-GIRO EXT","C","0020230509","AG. NORTE","176,400.00","184,288.42"
10/01/2025,"001055","10626833-COSTO IVA CASH-PT-099323326900","D","0002570894","AG. NORTE","0.05","7,888.42"
10/01/2025,"001055","10626833-COSTO OPER CASH-PT-099323326900","D","0002570851","AG. NORTE","0.36","7,888.47"
10/01/2025,"001055","10626561-COSTO IVA CASH-PT-099323326900","D","0002570660","AG. NORTE","0.05","7,888.83"
10/01/2025,"001055","10626561-COSTO OPER CASH-PT-099323326900","D","0002570600","AG. NORTE","0.36","7,888.88"
10/01/2025,"001055","10611128-COSTO IVA CASH-PT-099323326900","D","0002570532","AG. NORTE","0.05","7,889.24"
10/01/2025,"001055","10611128-COSTO OPER CASH-PT-099323326900","D","0002570501","AG. NORTE","0.36","7,889.29"
10/01/2025,"001055","10611023-COSTO IVA CASH-PT-099323326900","D","0002570388","AG. NORTE","0.05","7,889.65"
10/01/2025,"001055","10611023-COSTO OPER CASH-PT-099323326900","D","0002568154","AG. NORTE","0.36","7,889.70"
10/01/2025,"001055","10610545-COSTO IVA CASH-PT-099323326900","D","0002568005","AG. NORTE","0.05","7,890.06"
10/01/2025,"001055","10610545-COSTO OPER CASH-PT-099323326900","D","0002569455","AG. NORTE","0.36","7,890.11"
10/01/2025,"001055","10610464-COSTO IVA CASH-PT-099323326900","D","0002567853","AG. NORTE","0.05","7,890.47"
10/01/2025,"001055","10610464-COSTO OPER CASH-PT-099323326900","D","0002567817","AG. NORTE","0.36","7,890.52"
10/01/2025,"001055","10610178-COSTO IVA CASH-PT-099323326900","D","0002567717","AG. NORTE","0.05","7,890.88"
10/01/2025,"001055","10610178-COSTO OPER CASH-PT-099323326900","D","0002569084","AG. NORTE","0.36","7,890.93"
10/01/2025,"001055","10607531-COSTO IVA CASH-PT-099323326900","D","0002567581","AG. NORTE","0.05","7,891.29"
10/01/2025,"001055","10607531-COSTO OPER CASH-PT-099323326900","D","0002567542","AG. NORTE","0.36","7,891.34"
10/01/2025,"001055","10606483-COSTO IVA CASH-PT-099323326900","D","0002567421","AG. NORTE","0.05","7,891.70"
10/01/2025,"001055","10606483-COSTO OPER CASH-PT-099323326900","D","0002568720","AG. NORTE","0.36","7,891.75"
10/01/2025,"001055","10606137-COSTO IVA CASH-PT-099323326900","D","0002568576","AG. NORTE","0.05","7,892.11"
10/01/2025,"001055","10606137-COSTO OPER CASH-PT-099323326900","D","0002567239","AG. NORTE","0.36","7,892.16"
10/01/2025,"001055","10590984-COSTO IVA CASH-PT-099323326900","D","0002567009","AG. NORTE","0.05","7,892.52"
10/01/2025,"001055","10590984-COSTO OPER CASH-PT-099323326900","D","0002568217","AG. NORTE","0.36","7,892.57"
10/01/2025,"001055","10582266-COSTO IVA CASH-PT-099323326900","D","0002566869","AG. NORTE","0.05","7,892.93"
10/01/2025,"001055","10582266-COSTO OPER CASH-PT-099323326900","D","0002566823","AG. NORTE","0.36","7,892.98"
10/01/2025,"001055","10524403-COSTO IVA CASH-PT-099323326900","D","0002566723","AG. NORTE","0.05","7,893.34"
10/01/2025,"001055","10524403-COSTO OPER CASH-PT-099323326900","D","0002566679","AG. NORTE","0.36","7,893.39"
09/01/2025,"001055","10626833-SINOBALSA SA-PT-ZUKALO F694860","D","0055131872","AG. NORTE","749.68","7,893.75"
09/01/2025,"001055","10626561-SINOBALSA SA-PT-interquimiec 9E","D","0055126320","AG. NORTE","2,517.35","8,643.43"
09/01/2025,"001055","10611023-SINOBALSA SA-PT-NOLIMIT SERVICE","D","0025502311","AG. NORTE","30.80","11,160.78"
09/01/2025,"001055","10611128-SINOBALSA SA-PT-LUZ  F 07099900","D","0025441195","AG. NORTE","6,646.46","11,191.58"
09/01/2025,"001055","10610545-SINOBALSA SA-PT-AEROBALSA ANT","D","0023237959","AG. NORTE","25,000.00","17,838.04"
09/01/2025,"001055","10610178-SINOBALSA SA-PT-CONDOR","D","0023243818","AG. NORTE","50,000.00","42,838.04"
09/01/2025,"001055","10610464-SINOBALSA SA-PT-CONDOR PRESTAMO","D","0023237643","AG. NORTE","50,000.00","92,838.04"
09/01/2025,"001055","10607531-SINOBALSA SA-PT-725 VERA PABLO","D","0020362273","AG. NORTE","1,707.12","142,838.04"
09/01/2025,"001055","10582266-SINOBALSA SA-PT-AEROBALSAEXPORT","D","0018293184","AG. NORTE","10,734.80","144,545.16"
09/01/2025,"001055","10606483-SINOBALSA SA-PT-724 MEDINA JOSE","D","0018293057","AG. NORTE","1,201.60","155,279.96"
09/01/2025,"001055","10606137-SINOBALSA SA-PT-ROBLES EDUARDO","D","0018292681","AG. NORTE","116.70","156,481.56"
09/01/2025,"001055","10590984-SINOBALSA SA-PT-ALCANCE F107435","D","0018292503","AG. NORTE","99.63","156,598.26"
09/01/2025,"001055","10524403-SINOBALSA SA-PT-FRANK DEVOLUCIO","D","0017169565","AG. NORTE","20,000.00","156,697.89"
09/01/2025,"001045","S065009043C301-JIANGSU SINO NEW-GIRO EXT","C","0017055066","AG. NORTE","176,400.00","176,697.89"
09/01/2025,"001055","10582168-COSTO IVA CASH-PT-099323326900","D","0002365392","AG. NORTE","0.05","297.89"
09/01/2025,"001055","10582168-COSTO OPER CASH-PT-099323326900","D","0002365325","AG. NORTE","0.36","297.94"
09/01/2025,"001055","10567968-COSTO IVA CASH-PT-099323326900","D","0002365206","AG. NORTE","0.05","298.30"
09/01/2025,"001055","10567968-COSTO OPER CASH-PT-099323326900","D","0002364194","AG. NORTE","0.36","298.35"
09/01/2025,"001055","10552537-COSTO IVA CASH-PT-099323326900","D","0002365090","AG. NORTE","0.11","298.71"
09/01/2025,"001055","10552537-COSTO OPER CASH-PT-099323326900","D","0002365054","AG. NORTE","0.71","298.82"
09/01/2025,"001055","10552242-COSTO IVA CASH-PT-099323326900","D","0002363964","AG. NORTE","0.75","299.53"
09/01/2025,"001055","10552242-COSTO OPER CASH-PT-099323326900","D","0002364909","AG. NORTE","4.99","300.28"
08/01/2025,"001055","10582168-SINOBALSA SA-PT-AEROBALSAEXPORT","D","0040134641","AG. NORTE","15,000.00","305.27"
08/01/2025,"001045","TRANSFERENCIA INTERNET","C","0039947194","AG. NORTE","7,000.00","15,305.27"
08/01/2025,"001055","10567968-SINOBALSA SA-PT-PORTEO 4X40 ZIM","D","0013181060","AG. NORTE","568.75","8,305.27"
08/01/2025,"001055","10552537-COSTO IVA CASH-PT-099323326900","D","0002357039","AG. NORTE","0.05","8,874.02"
08/01/2025,"001055","10552537-COSTO OPER CASH-PT-099323326900","D","0002357008","AG. NORTE","0.36","8,874.07"
08/01/2025,"001055","10552242-COSTO IVA CASH-PT-099323326900","D","0002356857","AG. NORTE","2.67","8,874.43"
08/01/2025,"001055","10552242-COSTO OPER CASH-PT-099323326900","D","0002355565","AG. NORTE","17.83","8,877.10"
08/01/2025,"001055","10545501-COSTO IVA CASH-PT-099323326900","D","0002355433","AG. NORTE","0.05","8,894.93"
08/01/2025,"001055","10545501-COSTO OPER CASH-PT-099323326900","D","0002355384","AG. NORTE","0.36","8,894.98"
08/01/2025,"001055","10524488-COSTO IVA CASH-PT-099323326900","D","0002356546","AG. NORTE","0.05","8,895.34"
08/01/2025,"001055","10524488-COSTO OPER CASH-PT-099323326900","D","0002356524","AG. NORTE","0.36","8,895.39"
08/01/2025,"001055","10524214-COSTO IVA CASH-PT-099323326900","D","0002356428","AG. NORTE","0.05","8,895.75"
08/01/2025,"001055","10524214-COSTO OPER CASH-PT-099323326900","D","0002356397","AG. NORTE","0.36","8,895.80"
08/01/2025,"001055","10523890-COSTO IVA CASH-PT-099323326900","D","0002354988","AG. NORTE","0.05","8,896.16"
08/01/2025,"001055","10523890-COSTO OPER CASH-PT-099323326900","D","0002354929","AG. NORTE","0.36","8,896.21"
08/01/2025,"001055","10511510-COSTO IVA CASH-PT-099323326900","D","0002356115","AG. NORTE","0.05","8,896.57"
08/01/2025,"001055","10511510-COSTO OPER CASH-PT-099323326900","D","0002354786","AG. NORTE","0.36","8,896.62"
08/01/2025,"001055","10511469-COSTO IVA CASH-PT-099323326900","D","0002355968","AG. NORTE","0.05","8,896.98"
08/01/2025,"001055","10511469-COSTO OPER CASH-PT-099323326900","D","0002354540","AG. NORTE","0.36","8,897.03"
08/01/2025,"001055","10511420-COSTO IVA CASH-PT-099323326900","D","0002354427","AG. NORTE","0.05","8,897.39"
08/01/2025,"001055","10511420-COSTO OPER CASH-PT-099323326900","D","0002354387","AG. NORTE","0.36","8,897.44"
07/01/2025,"001055","10552537-SINOBALSA SA-PT-ROL DE 3TRAB","D","0048951114","AG. NORTE","150.00","8,897.80"
07/01/2025,"001055","10552242-SINOBALSA SA-PT-ROL DIC31 DIFER","D","0048950418","AG. NORTE","8,580.91","9,047.80"
07/01/2025,"001055","10545501-SINOBALSA SA-PT-PORTEO 1X40 ZIM","D","0043337561","AG. NORTE","150.06","17,628.71"
07/01/2025,"001055","10518906-COSTO IVA CASH-PT-099323326900","D","0003140224","AG. NORTE","0.05","17,778.77"
07/01/2025,"001055","10518906-COSTO OPER CASH-PT-099323326900","D","0003143408","AG. NORTE","0.36","17,778.82"
07/01/2025,"001055","10514735-COSTO IVA CASH-PT-099323326900","D","0003139810","AG. NORTE","0.05","17,779.18"
07/01/2025,"001055","10514735-COSTO OPER CASH-PT-099323326900","D","0003143014","AG. NORTE","0.36","17,779.23"
07/01/2025,"001055","10495583-COSTO IVA CASH-PT-099323326900","D","0003139277","AG. NORTE","0.05","17,779.59"
07/01/2025,"001055","10495583-COSTO OPER CASH-PT-099323326900","D","0003142480","AG. NORTE","0.36","17,779.64"
07/01/2025,"001055","10495498-COSTO IVA CASH-PT-099323326900","D","0003142126","AG. NORTE","0.05","17,780.00"
07/01/2025,"001055","10495498-COSTO OPER CASH-PT-099323326900","D","0003142045","AG. NORTE","0.36","17,780.05"
07/01/2025,"001055","10495399-COSTO IVA CASH-PT-099323326900","D","0003138456","AG. NORTE","0.05","17,780.41"
07/01/2025,"001055","10495399-COSTO OPER CASH-PT-099323326900","D","0003141711","AG. NORTE","0.36","17,780.46"
07/01/2025,"001055","10489290-COSTO IVA CASH-PT-099323326900","D","0003141422","AG. NORTE","0.05","17,780.82"
07/01/2025,"001055","10489290-COSTO OPER CASH-PT-099323326900","D","0003137993","AG. NORTE","0.36","17,780.87"
07/01/2025,"001055","10487717-COSTO IVA CASH-PT-099323326900","D","0003141050","AG. NORTE","0.05","17,781.23"
07/01/2025,"001055","10487717-COSTO OPER CASH-PT-099323326900","D","0003140965","AG. NORTE","0.36","17,781.28"
07/01/2025,"001055","10439591-COSTO IVA CASH-PT-099323326900","D","0003140670","AG. NORTE","0.05","17,781.64"
07/01/2025,"001055","10439591-COSTO OPER CASH-PT-099323326900","D","0003137207","AG. NORTE","0.36","17,781.69"
07/01/2025,"001055","10524488-SINOBALSA SA-PT-SUELDO ENERO MA","D","0000771095","AG. NORTE","700.00","17,782.05"
07/01/2025,"001055","10524214-SINOBALSA SA-PT-AEROBALSAEXPORT","D","0000766256","AG. NORTE","16,377.34","18,482.05"
07/01/2025,"001055","10523890-SINOBALSA SA-PT-prestamo condor","D","0000761199","AG. NORTE","70,000.00","34,859.39"
06/01/2025,"001055","10518906-SINOBALSA SA-PT-INTERQUIMEC 6EN","D","0282827944","AG. NORTE","2,517.35","104,859.39"
06/01/2025,"001055","10495498-SINOBALSA SA-PT-703 LOPEZ DANNY","D","0282827577","AG. NORTE","1,052.99","107,376.74"
06/01/2025,"001055","10514735-SINOBALSA SA-PT-L015 ALAVA GLAD","D","0282820763","AG. NORTE","847.04","108,429.73"
06/01/2025,"001055","10495399-SINOBALSA SA-PT-SIN 700 GARCIA","D","0282827350","AG. NORTE","1,846.55","109,276.77"
06/01/2025,"001055","10495583-SINOBALSA SA-PT-705 GARCIA RODO","D","0282827226","AG. NORTE","1,577.07","111,123.32"
06/01/2025,"001055","10511469-SINOBALSA SA-PT-CERTIFICADOS  4","D","0282606739","AG. NORTE","126.36","112,700.39"
06/01/2025,"001055","10511420-SINOBALSA SA-PT-LOGICST F1354 T","D","0282606322","AG. NORTE","1,019.70","112,826.75"
06/01/2025,"001055","10511510-SINOBALSA SA-PT-TURNO 5X40 ZIMU","D","0282598720","AG. NORTE","243.12","113,846.45"
06/01/2025,"001055","10487717-SINOBALSA SA-PT-TIBA F21821F218","D","0242555495","AG. NORTE","1,524.61","114,089.57"
06/01/2025,"001055","10489290-SINOBALSA SA-PT-CONDOR PRESTAMO","D","0242555042","AG. NORTE","30,000.00","115,614.18"
06/01/2025,"001055","10439591-SINOBALSA SA-PT-TIBA F21819F218","D","0232732851","AG. NORTE","425.51","145,614.18"
06/01/2025,"001045","S0650030D61901-JIANGSU SINO NEW-GIRO EXT","C","0095163607","AG. NORTE","144,000.00","146,039.69"
