"Fecha","Codigo","Concepto","Tipo","Documento","Oficina","Monto","Saldo"
31/10/2024,"001045","S0643050E0D701-8702069-GIRO-EXT","C","0018692108","AG. NORTE","112,800.00","148,749.68"
29/10/2024,"001055","08549039-COSTO IVA CASH-PT-099323326900","D","0003250680","AG. NORTE","0.05","35,949.68"
29/10/2024,"001055","08549039-COSTO OPER CASH-PT-099323326900","D","0003248847","AG. NORTE","0.36","35,949.73"
29/10/2024,"001055","08549014-COSTO IVA CASH-PT-099323326900","D","0003250377","AG. NORTE","0.05","35,950.09"
29/10/2024,"001055","08549014-COSTO OPER CASH-PT-099323326900","D","0003248554","AG. NORTE","0.36","35,950.14"
29/10/2024,"001055","08549004-COSTO IVA CASH-PT-099323326900","D","0003248368","AG. NORTE","0.05","35,950.50"
29/10/2024,"001055","08549004-COSTO OPER CASH-PT-099323326900","D","0003248332","AG. NORTE","0.36","35,950.55"
29/10/2024,"001055","08548990-COSTO IVA CASH-PT-099323326900","D","0003248153","AG. NORTE","0.05","35,950.91"
29/10/2024,"001055","08548990-COSTO OPER CASH-PT-099323326900","D","0003248105","AG. NORTE","0.36","35,950.96"
29/10/2024,"001055","08548928-COSTO IVA CASH-PT-099323326900","D","0003247366","AG. NORTE","0.05","35,951.32"
29/10/2024,"001055","08548928-COSTO OPER CASH-PT-099323326900","D","0003247905","AG. NORTE","0.36","35,951.37"
29/10/2024,"001055","08548913-COSTO IVA CASH-PT-099323326900","D","0003247735","AG. NORTE","0.05","35,951.73"
29/10/2024,"001055","08548913-COSTO OPER CASH-PT-099323326900","D","0003247700","AG. NORTE","0.36","35,951.78"
29/10/2024,"001055","08548869-COSTO IVA CASH-PT-099323326900","D","0003245207","AG. NORTE","0.05","35,952.14"
29/10/2024,"001055","08548869-COSTO OPER CASH-PT-099323326900","D","0003246881","AG. NORTE","0.36","35,952.19"
29/10/2024,"001055","08548859-COSTO IVA CASH-PT-099323326900","D","0003244975","AG. NORTE","0.05","35,952.55"
29/10/2024,"001055","08548859-COSTO OPER CASH-PT-099323326900","D","0003244929","AG. NORTE","0.36","35,952.60"
29/10/2024,"001055","08548844-COSTO IVA CASH-PT-099323326900","D","0003244711","AG. NORTE","0.05","35,952.96"
29/10/2024,"001055","08548844-COSTO OPER CASH-PT-099323326900","D","0003246346","AG. NORTE","0.36","35,953.01"
29/10/2024,"001055","08548837-COSTO IVA CASH-PT-099323326900","D","0003246155","AG. NORTE","0.05","35,953.37"
29/10/2024,"001055","08548837-COSTO OPER CASH-PT-099323326900","D","0003246101","AG. NORTE","0.36","35,953.42"
29/10/2024,"001055","08548801-COSTO IVA CASH-PT-099323326900","D","0003245887","AG. NORTE","0.11","35,953.78"
29/10/2024,"001055","08548801-COSTO OPER CASH-PT-099323326900","D","0003245752","AG. NORTE","0.76","35,953.89"
29/10/2024,"001055","08548787-COSTO IVA CASH-PT-099323326900","D","0003245514","AG. NORTE","0.11","35,954.65"
29/10/2024,"001055","08548787-COSTO OPER CASH-PT-099323326900","D","0003243821","AG. NORTE","0.76","35,954.76"
29/10/2024,"001055","08548765-COSTO IVA CASH-PT-099323326900","D","0003243635","AG. NORTE","0.05","35,955.52"
29/10/2024,"001055","08548765-COSTO OPER CASH-PT-099323326900","D","0003245233","AG. NORTE","0.36","35,955.57"
29/10/2024,"001055","08548747-COSTO IVA CASH-PT-099323326900","D","0003242881","AG. NORTE","0.05","35,955.93"
29/10/2024,"001055","08548747-COSTO OPER CASH-PT-099323326900","D","0003242835","AG. NORTE","0.36","35,955.98"
29/10/2024,"001055","08515359-COSTO IVA CASH-PT-099323326900","D","0003243225","AG. NORTE","0.05","35,956.34"
29/10/2024,"001055","08515359-COSTO OPER CASH-PT-099323326900","D","0003243183","AG. NORTE","0.36","35,956.39"
29/10/2024,"001055","08515337-COSTO IVA CASH-PT-099323326900","D","0003242438","AG. NORTE","0.05","35,956.75"
29/10/2024,"001055","08515337-COSTO OPER CASH-PT-099323326900","D","0003240730","AG. NORTE","0.36","35,956.80"
29/10/2024,"001055","08336183-COSTO IVA CASH-PT-099323326900","D","0003242194","AG. NORTE","0.05","35,957.16"
29/10/2024,"001055","08336183-COSTO OPER CASH-PT-099323326900","D","0003242151","AG. NORTE","0.36","35,957.21"
29/10/2024,"001055","08335871-COSTO IVA CASH-PT-099323326900","D","0003241869","AG. NORTE","0.05","35,957.57"
29/10/2024,"001055","08335871-COSTO OPER CASH-PT-099323326900","D","0003240180","AG. NORTE","0.36","35,957.62"
29/10/2024,"001055","08195575-COSTO IVA CASH-PT-099323326900","D","0003241629","AG. NORTE","0.05","35,957.98"
29/10/2024,"001055","08195575-COSTO OPER CASH-PT-099323326900","D","0003239972","AG. NORTE","0.36","35,958.03"
28/10/2024,"001330","08548801-SINOBALSA SA        -538 CASTRO CESA","D","0103633562","LA PIAZZA","175.00","35,958.39"
28/10/2024,"001330","08548787-SINOBALSA SA        -538 CASTRO CESA","D","0103526001","LA PIAZZA","1,900.00","36,133.39"
28/10/2024,"001045","8548747-SINOBALSA SA-PT-546 MEDINA JOSE","C","0084920732","AG. NORTE","2,633.99","38,033.39"
28/10/2024,"001055","8548837-SINOBALSA SA-PT-nuevo pedido 25","D","0081199654","AG. NORTE","2,517.35","35,399.40"
28/10/2024,"001055","8548913-SINOBALSA SA-PT-525 chichande a","D","0081199401","AG. NORTE","2,337.70","37,916.75"
28/10/2024,"001055","8549039-SINOBALSA SA-PT-552 VERA PABLO","D","0081200115","AG. NORTE","1,845.69","40,254.45"
28/10/2024,"001055","8548859-SINOBALSA SA-PT-TURNO TERCON 2X","D","0081199164","AG. NORTE","90.42","42,100.14"
28/10/2024,"001055","8548765-SINOBALSA SA-PT-540 CUJILAN JOS","D","0081200016","AG. NORTE","1,964.29","42,190.56"
28/10/2024,"001055","8548928-SINOBALSA SA-PT-542 moyan ferna","D","0081199905","AG. NORTE","1,682.75","44,154.85"
28/10/2024,"001055","8548844-SINOBALSA SA-PT-PORTEO 2X40 679","D","0081198465","AG. NORTE","262.81","45,837.60"
28/10/2024,"001055","8548869-SINOBALSA SA-PT-TRANSPORTE INTE","D","0081198375","AG. NORTE","653.40","46,100.41"
28/10/2024,"001055","8549004-SINOBALSA SA-PT-529 CUJILAN JOS","D","0081198570","AG. NORTE","2,129.91","46,753.81"
28/10/2024,"001055","8549014-SINOBALSA SA-PT-L012 ZAMBRANO G","D","0081197936","AG. NORTE","855.95","48,883.72"
28/10/2024,"001055","8548990-SINOBALSA SA-PT-539 cujilan jos","D","0081197066","AG. NORTE","2,307.65","49,739.67"
28/10/2024,"001055","8515337-SINOBALSA SA-PT-543 GUAMAN MEDA","D","0081197935","AG. NORTE","1,867.05","52,047.32"
28/10/2024,"001055","8548747-SINOBALSA SA-PT-546 MEDINA JOSE","D","0081197838","AG. NORTE","2,633.99","53,914.37"
28/10/2024,"001055","8515359-SINOBALSA SA-PT-545 VERA PABLO","D","0081196579","AG. NORTE","2,146.91","56,548.36"
28/10/2024,"001055","8335871-SINOBALSA SA-PT-C011 PALOMEQUE","D","0081195876","AG. NORTE","1,388.00","58,695.27"
28/10/2024,"001055","8336183-SINOBALSA SA-PT-540 GUJILAN WIL","D","0081194427","AG. NORTE","1,964.28","60,083.27"
28/10/2024,"001055","8195575-SINOBALSA SA-PT-536 LOPEZ DANNY","D","0081195197","AG. NORTE","989.00","62,047.55"
28/10/2024,"001331","DB AH PROGRAMADO","D","0003099578","AGENCIA PARA PROCESOS BATCH","1,500.00","63,036.55"
22/10/2024,"001055","COBRO INTERBANCARIO RECIBIDO","D","0027039047","CENTRO SERVIC. OPERAT. SS. QTO","18.09","64,536.55"
22/10/2024,"001055","COBRO INTERBANCARIO RECIBIDO IVA","D","0027039047","CENTRO SERVIC. OPERAT. SS. QTO","0.03","64,554.64"
22/10/2024,"001055","COBRO INTERBANCARIO RECIBIDO COMISION","D","0027039047","CENTRO SERVIC. OPERAT. SS. QTO","0.20","64,554.67"
22/10/2024,"001055","COBRO INTERBANCARIO RECIBIDO","D","0026891958","CENTRO SERVIC. OPERAT. SS. QTO","1,309.09","64,554.87"
22/10/2024,"001055","COBRO INTERBANCARIO RECIBIDO IVA","D","0026891958","CENTRO SERVIC. OPERAT. SS. QTO","0.03","65,863.96"
22/10/2024,"001055","COBRO INTERBANCARIO RECIBIDO COMISION","D","0026891958","CENTRO SERVIC. OPERAT. SS. QTO","0.20","65,863.99"
22/10/2024,"001055","08381709-COSTO IVA CASH-PT-099323326900","D","0003207722","AG. NORTE","0.37","65,864.19"
22/10/2024,"001055","08381709-COSTO OPER CASH-PT-099323326900","D","0003206417","AG. NORTE","2.50","65,864.56"
22/10/2024,"001055","08381709-COSTO IVA CASH-PT-099323326900","D","0003206261","AG. NORTE","0.05","65,867.06"
22/10/2024,"001055","08381709-COSTO OPER CASH-PT-099323326900","D","0003207448","AG. NORTE","0.36","65,867.11"
22/10/2024,"001055","08381708-COSTO IVA CASH-PT-099323326900","D","0003207275","AG. NORTE","0.05","65,867.47"
22/10/2024,"001055","08381708-COSTO OPER CASH-PT-099323326900","D","0003207236","AG. NORTE","0.36","65,867.52"
22/10/2024,"001055","08381708-COSTO IVA CASH-PT-099323326900","D","0003207085","AG. NORTE","0.16","65,867.88"
22/10/2024,"001055","08381708-COSTO OPER CASH-PT-099323326900","D","0003205813","AG. NORTE","1.07","65,868.04"
22/10/2024,"001055","08381707-COSTO IVA CASH-PT-099323326900","D","0003206900","AG. NORTE","0.32","65,869.11"
22/10/2024,"001055","08381707-COSTO OPER CASH-PT-099323326900","D","0003206847","AG. NORTE","2.14","65,869.43"
22/10/2024,"001055","08381707-COSTO IVA CASH-PT-099323326900","D","0003204560","AG. NORTE","0.05","65,871.57"
22/10/2024,"001055","08381707-COSTO OPER CASH-PT-099323326900","D","0003204510","AG. NORTE","0.36","65,871.62"
22/10/2024,"001055","08381707-COSTO IVA CASH-PT-099323326900","D","0003205220","AG. NORTE","0.05","65,871.98"
22/10/2024,"001055","08381707-COSTO OPER CASH-PT-099323326900","D","0003205173","AG. NORTE","0.36","65,872.03"
21/10/2024,"001045","8381707-SINOBALSA SA-PT-ROL 15OCT DIFER","C","0114996213","AG. NORTE","22.50","65,872.39"
21/10/2024,"001055","8381707-SINOBALSA SA-PT-ROL 15OCT DIFER","D","0053187324","AG. NORTE","224.40","65,849.89"
21/10/2024,"001055","8381708-SINOBALSA SA-PT-ROL 15OCT TRABA","D","0053187319","AG. NORTE","941.00","66,074.29"
21/10/2024,"001055","8381709-SINOBALSA SA-PT-ROL15OCT DIFE E","D","0053186609","AG. NORTE","1,119.90","67,015.29"
18/10/2024,"051072","PAGO CHEQUE","D","0000000516","GUAYAQUIL TORRES PICHINCHA","18,300.00","68,135.19"
18/10/2024,"001055","08307932-COSTO IVA CASH-PT-099323326900","D","0002635817","AG. NORTE","1.76","86,435.19"
18/10/2024,"001055","08307932-COSTO OPER CASH-PT-099323326900","D","0002635776","AG. NORTE","11.77","86,436.95"
18/10/2024,"001055","08307932-COSTO IVA CASH-PT-099323326900","D","0002635713","AG. NORTE","0.48","86,448.72"
18/10/2024,"001055","08307932-COSTO OPER CASH-PT-099323326900","D","0002635694","AG. NORTE","3.21","86,449.20"
18/10/2024,"001055","08307754-COSTO IVA CASH-PT-099323326900","D","0002637081","AG. NORTE","0.05","86,452.41"
18/10/2024,"001055","08307754-COSTO OPER CASH-PT-099323326900","D","0002635504","AG. NORTE","0.36","86,452.46"
18/10/2024,"001055","08298805-COSTO IVA CASH-PT-099323326900","D","0002634963","AG. NORTE","0.05","86,452.82"
18/10/2024,"001055","08298805-COSTO OPER CASH-PT-099323326900","D","0002635281","AG. NORTE","0.36","86,452.87"
18/10/2024,"001055","08289095-COSTO IVA CASH-PT-099323326900","D","0002635083","AG. NORTE","0.05","86,453.23"
18/10/2024,"001055","08289095-COSTO OPER CASH-PT-099323326900","D","0002633358","AG. NORTE","0.36","86,453.28"
18/10/2024,"001055","08288832-COSTO IVA CASH-PT-099323326900","D","0002633284","AG. NORTE","0.05","86,453.64"
18/10/2024,"001055","08288832-COSTO OPER CASH-PT-099323326900","D","0002634550","AG. NORTE","0.36","86,453.69"
18/10/2024,"001055","08288452-COSTO IVA CASH-PT-099323326900","D","0002634351","AG. NORTE","0.05","86,454.05"
18/10/2024,"001055","08288452-COSTO OPER CASH-PT-099323326900","D","0002634291","AG. NORTE","0.36","86,454.10"
18/10/2024,"001055","08288323-COSTO IVA CASH-PT-099323326900","D","0002632818","AG. NORTE","0.05","86,454.46"
18/10/2024,"001055","08288323-COSTO OPER CASH-PT-099323326900","D","0002632773","AG. NORTE","0.36","86,454.51"
18/10/2024,"001055","08287773-COSTO IVA CASH-PT-099323326900","D","0002634001","AG. NORTE","0.05","86,454.87"
18/10/2024,"001055","08287773-COSTO OPER CASH-PT-099323326900","D","0002633951","AG. NORTE","0.36","86,454.92"
18/10/2024,"001055","08287696-COSTO IVA CASH-PT-099323326900","D","0002633903","AG. NORTE","0.05","86,455.28"
18/10/2024,"001055","08287696-COSTO OPER CASH-PT-099323326900","D","0002633873","AG. NORTE","0.36","86,455.33"
18/10/2024,"001055","08287355-COSTO IVA CASH-PT-099323326900","D","0002632392","AG. NORTE","0.05","86,455.69"
18/10/2024,"001055","08287355-COSTO OPER CASH-PT-099323326900","D","0002633723","AG. NORTE","0.36","86,455.74"
17/10/2024,"001055","8307754-SINOBALSA SA-PT-PORTEO 4X40 633","D","0027680175","AG. NORTE","525.62","86,456.10"
17/10/2024,"001055","8307932-SINOBALSA SA-PT-ROLES OCT 15","D","0027679754","AG. NORTE","11,562.40","86,981.72"
17/10/2024,"001055","8298805-SINOBALSA SA-PT-TURNO 4X40 BLAS","D","0013447621","AG. NORTE","144.90","98,544.12"
17/10/2024,"001055","8287773-SINOBALSA SA-PT-531 KUKUSH SHAU","D","0012227830","AG. NORTE","3,008.01","98,689.02"
17/10/2024,"001055","8288323-SINOBALSA SA-PT-535 VERA PABLO","D","0012220792","AG. NORTE","2,145.03","101,697.03"
17/10/2024,"001055","8287355-SINOBALSA SA-PT-524 ZAMBRANO JH","D","0012220561","AG. NORTE","2,113.34","103,842.06"
17/10/2024,"001055","8289095-SINOBALSA SA-PT-TIBA HAPAG BK 6","D","0012227463","AG. NORTE","700.29","105,955.40"
17/10/2024,"001055","8287696-SINOBALSA SA-PT-527 ZAMBRANO JH","D","0012220447","AG. NORTE","1,876.06","106,655.69"
17/10/2024,"001055","8288452-SINOBALSA SA-PT-541 VERA PABLO","D","0012227368","AG. NORTE","1,517.60","108,531.75"
17/10/2024,"001055","8288832-SINOBALSA SA-PT-TURNO 4X40 BLAS","D","0012227273","AG. NORTE","48.30","110,049.35"
17/10/2024,"001055","08274118-COSTO IVA CASH-PT-099323326900","D","0002853143","AG. NORTE","0.05","110,097.65"
17/10/2024,"001055","08274118-COSTO OPER CASH-PT-099323326900","D","0002853025","AG. NORTE","0.36","110,097.70"
17/10/2024,"001055","08273988-COSTO IVA CASH-PT-099323326900","D","0002852848","AG. NORTE","0.05","110,098.06"
17/10/2024,"001055","08273988-COSTO OPER CASH-PT-099323326900","D","0002850868","AG. NORTE","0.36","110,098.11"
17/10/2024,"001055","08273652-COSTO IVA CASH-PT-099323326900","D","0002850705","AG. NORTE","0.05","110,098.47"
17/10/2024,"001055","08273652-COSTO OPER CASH-PT-099323326900","D","0002852604","AG. NORTE","0.36","110,098.52"
17/10/2024,"001055","08272082-COSTO IVA CASH-PT-099323326900","D","0002850503","AG. NORTE","0.05","110,098.88"
17/10/2024,"001055","08272082-COSTO OPER CASH-PT-099323326900","D","0002850455","AG. NORTE","0.36","110,098.93"
17/10/2024,"001055","08271894-COSTO IVA CASH-PT-099323326900","D","0002852270","AG. NORTE","0.05","110,099.29"
17/10/2024,"001055","08271894-COSTO OPER CASH-PT-099323326900","D","0002852227","AG. NORTE","0.36","110,099.34"
17/10/2024,"001055","08195674-COSTO IVA CASH-PT-099323326900","D","0002852082","AG. NORTE","0.05","110,099.70"
17/10/2024,"001055","08195674-COSTO OPER CASH-PT-099323326900","D","0002850095","AG. NORTE","0.36","110,099.75"
17/10/2024,"001055","08133162-COSTO IVA CASH-PT-099323326900","D","0002849923","AG. NORTE","0.05","110,100.11"
17/10/2024,"001055","08133162-COSTO OPER CASH-PT-099323326900","D","0002849871","AG. NORTE","0.36","110,100.16"
17/10/2024,"001055","08132826-COSTO IVA CASH-PT-099323326900","D","0002851655","AG. NORTE","0.05","110,100.52"
17/10/2024,"001055","08132826-COSTO OPER CASH-PT-099323326900","D","0002851617","AG. NORTE","0.36","110,100.57"
17/10/2024,"001055","07972023-COSTO IVA CASH-PT-099323326900","D","0002851466","AG. NORTE","0.05","110,100.93"
17/10/2024,"001055","07972023-COSTO OPER CASH-PT-099323326900","D","0002849468","AG. NORTE","0.36","110,100.98"
16/10/2024,"001055","8273652-SINOBALSA SA-PT-INTERQUIMEC OCT","D","0036978903","AG. NORTE","2,517.35","110,101.34"
16/10/2024,"001055","8132826-SINOBALSA SA-PT-526 VERA PABLO","D","0036972520","AG. NORTE","2,431.95","112,618.69"
16/10/2024,"001055","8195674-SINOBALSA SA-PT-533 LOPEZ DANNY","D","0036971984","AG. NORTE","925.70","115,050.64"
16/10/2024,"001055","8133162-SINOBALSA SA-PT-528 CHICHANDE A","D","0036977348","AG. NORTE","2,397.84","115,976.34"
16/10/2024,"001055","8271894-SINOBALSA SA-PT-537 MOYAN FERNA","D","0036971606","AG. NORTE","2,196.48","118,374.18"
16/10/2024,"001055","8273988-SINOBALSA SA-PT-TRANSP 2X40 F11","D","0036960062","AG. NORTE","440.00","120,570.66"
16/10/2024,"001055","8274118-SINOBALSA SA-PT-CERTIF COMEX Y","D","0036965752","AG. NORTE","63.18","121,010.66"
16/10/2024,"001055","8272082-SINOBALSA SA-PT-534 MOYAN FERNA","D","0036965569","AG. NORTE","2,239.52","121,073.84"
16/10/2024,"001055","7972023-SINOBALSA SA-PT-MAMBA WOOD F97","D","0036963299","AG. NORTE","25,945.92","123,313.36"
15/10/2024,"001055","08195194-COSTO IVA CASH-PT-099323326900","D","0003708966","AG. NORTE","0.05","149,259.28"
15/10/2024,"001055","08195194-COSTO OPER CASH-PT-099323326900","D","0003708861","AG. NORTE","0.36","149,259.33"
15/10/2024,"001055","08194767-COSTO IVA CASH-PT-099323326900","D","0003708518","AG. NORTE","0.05","149,259.69"
15/10/2024,"001055","08194767-COSTO OPER CASH-PT-099323326900","D","0003708425","AG. NORTE","0.36","149,259.74"
15/10/2024,"001055","08179096-COSTO IVA CASH-PT-099323326900","D","0003708056","AG. NORTE","0.05","149,260.10"
15/10/2024,"001055","08179096-COSTO OPER CASH-PT-099323326900","D","0003705987","AG. NORTE","0.36","149,260.15"
15/10/2024,"001055","08141591-COSTO IVA CASH-PT-099323326900","D","0003707614","AG. NORTE","0.05","149,260.51"
15/10/2024,"001055","08141591-COSTO OPER CASH-PT-099323326900","D","0003703115","AG. NORTE","0.36","149,260.56"
15/10/2024,"001055","08104577-COSTO IVA CASH-PT-099323326900","D","0003702741","AG. NORTE","0.11","149,260.92"
15/10/2024,"001055","08104577-COSTO OPER CASH-PT-099323326900","D","0003702621","AG. NORTE","0.76","149,261.03"
15/10/2024,"001055","08097492-COSTO IVA CASH-PT-099323326900","D","0003704667","AG. NORTE","0.11","149,261.79"
15/10/2024,"001055","08097492-COSTO OPER CASH-PT-099323326900","D","0003702169","AG. NORTE","0.76","149,261.90"
14/10/2024,"001055","8194767-SINOBALSA SA-PT-C007 HUANG WENB","D","0308078291","AG. NORTE","1,020.00","149,262.66"
14/10/2024,"001055","8195194-SINOBALSA SA-PT-INTERNET OCTUBR","D","0308083941","AG. NORTE","30.80","150,282.66"
14/10/2024,"001055","8179096-SINOBALSA SA-PT-INTERQUIMEC  oc","D","0281219150","AG. NORTE","2,517.35","150,313.46"
14/10/2024,"001330","08097492-SINOBALSA SA        -522 CASTRO CESA","D","0279207961","LA PIAZZA","461.31","152,830.81"
14/10/2024,"001055","07978784-COSTO IVA CASH-PT-099323326900","D","0010807096","AG. NORTE","0.05","153,292.12"
14/10/2024,"001055","07978784-COSTO OPER CASH-PT-099323326900","D","0010806874","AG. NORTE","0.36","153,292.17"
14/10/2024,"001055","07968266-COSTO IVA CASH-PT-099323326900","D","0010806291","AG. NORTE","0.16","153,292.53"
14/10/2024,"001055","07968266-COSTO OPER CASH-PT-099323326900","D","0010800899","AG. NORTE","1.07","153,292.69"
14/10/2024,"001055","07968147-COSTO IVA CASH-PT-099323326900","D","0010800233","AG. NORTE","0.05","153,293.76"
14/10/2024,"001055","07968147-COSTO OPER CASH-PT-099323326900","D","0010805143","AG. NORTE","0.36","153,293.81"
14/10/2024,"001055","8158268-COSTO IVA CASH-GX-2024101000161589","D","0003990239","AG. NORTE","0.80","153,294.17"
14/10/2024,"001055","COMISION GIROS EXTERIOR","D","0003990175","AG. NORTE","5.36","153,294.97"
14/10/2024,"001045","2024101000161589-8158268-GIRO-EXT","C","0003992069","AG. NORTE","131,475.00","153,300.33"
14/10/2024,"001055","08142495-COSTO IVA CASH-PT-099323326900","D","0003364224","AG. NORTE","0.05","21,825.33"
14/10/2024,"001055","08142495-COSTO OPER CASH-PT-099323326900","D","0003364166","AG. NORTE","0.36","21,825.38"
14/10/2024,"001055","08141403-COSTO IVA CASH-PT-099323326900","D","0003364052","AG. NORTE","0.05","21,825.74"
14/10/2024,"001055","08141403-COSTO OPER CASH-PT-099323326900","D","0003363997","AG. NORTE","0.36","21,825.79"
14/10/2024,"001055","08140222-COSTO IVA CASH-PT-099323326900","D","0003363803","AG. NORTE","0.05","21,826.15"
14/10/2024,"001055","08140222-COSTO OPER CASH-PT-099323326900","D","0003362282","AG. NORTE","0.36","21,826.20"
14/10/2024,"001055","08139280-COSTO IVA CASH-PT-099323326900","D","0003363533","AG. NORTE","0.05","21,826.56"
14/10/2024,"001055","08139280-COSTO OPER CASH-PT-099323326900","D","0003363453","AG. NORTE","0.36","21,826.61"
14/10/2024,"001055","08134851-COSTO IVA CASH-PT-099323326900","D","0003363256","AG. NORTE","0.05","21,826.97"
14/10/2024,"001055","08134851-COSTO OPER CASH-PT-099323326900","D","0003363074","AG. NORTE","0.36","21,827.02"
14/10/2024,"001055","08134632-COSTO IVA CASH-PT-099323326900","D","0003361530","AG. NORTE","0.05","21,827.38"
14/10/2024,"001055","08134632-COSTO OPER CASH-PT-099323326900","D","0003362745","AG. NORTE","0.36","21,827.43"
14/10/2024,"001055","08133528-COSTO IVA CASH-PT-099323326900","D","0003361212","AG. NORTE","0.05","21,827.79"
14/10/2024,"001055","08133528-COSTO OPER CASH-PT-099323326900","D","0003360042","AG. NORTE","0.36","21,827.84"
14/10/2024,"001055","08113124-COSTO IVA CASH-PT-099323326900","D","0003359808","AG. NORTE","0.05","21,828.20"
14/10/2024,"001055","08113124-COSTO OPER CASH-PT-099323326900","D","0003360927","AG. NORTE","0.36","21,828.25"
10/10/2024,"001055","8141403-SINOBALSA SA-PT-499 moyan ferna","D","0062298961","AG. NORTE","2,893.75","21,828.61"
10/10/2024,"001055","8141591-SINOBALSA SA-PT-PORTEO TPG 2X40","D","0062297831","AG. NORTE","262.81","24,722.36"
10/10/2024,"001055","8140222-SINOBALSA SA-PT-508 lino jared","D","0062308410","AG. NORTE","633.79","24,985.17"
10/10/2024,"001055","8139280-SINOBALSA SA-PT-517 lino jared","D","0062308079","AG. NORTE","2,109.58","25,618.96"
10/10/2024,"001055","8133528-SINOBALSA SA-PT-502 LOPEZ DANNY","D","0062307713","AG. NORTE","1,080.31","27,728.54"
10/10/2024,"001055","8142495-SINOBALSA SA-PT-maribel octubre","D","0062297922","AG. NORTE","700.00","28,808.85"
10/10/2024,"001055","8134632-SINOBALSA SA-PT-L011 BREILH MAR","D","0062307365","AG. NORTE","991.38","29,508.85"
10/10/2024,"001055","8134851-SINOBALSA SA-PT-L009 BREILH MAR","D","0062297645","AG. NORTE","860.70","30,500.23"
10/10/2024,"001045","08145274-CONDOREXPLOTAR-PT-099323326900","C","0061540630","AG. NORTE","30,000.00","31,360.93"
10/10/2024,"001055","8113124-SINOBALSA SA-PT-TURNOS TERCON 2","D","0012536441","AG. NORTE","90.42","1,360.93"
10/10/2024,"001055","08102425-COSTO IVA CASH-PT-099323326900","D","0002941338","AG. NORTE","0.05","1,451.35"
10/10/2024,"001055","08102425-COSTO OPER CASH-PT-099323326900","D","0002941280","AG. NORTE","0.36","1,451.40"
10/10/2024,"001055","08101607-COSTO IVA CASH-PT-099323326900","D","0002938639","AG. NORTE","0.05","1,451.76"
10/10/2024,"001055","08101607-COSTO OPER CASH-PT-099323326900","D","0002938577","AG. NORTE","0.36","1,451.81"
10/10/2024,"001055","08100856-COSTO IVA CASH-PT-099323326900","D","0002938391","AG. NORTE","0.05","1,452.17"
10/10/2024,"001055","08100856-COSTO OPER CASH-PT-099323326900","D","0002940848","AG. NORTE","0.36","1,452.22"
10/10/2024,"001055","08100402-COSTO IVA CASH-PT-099323326900","D","0002940658","AG. NORTE","0.05","1,452.58"
10/10/2024,"001055","08100402-COSTO OPER CASH-PT-099323326900","D","0002940590","AG. NORTE","0.36","1,452.63"
10/10/2024,"001055","08100316-COSTO IVA CASH-PT-099323326900","D","0002940419","AG. NORTE","0.05","1,452.99"
10/10/2024,"001055","08100316-COSTO OPER CASH-PT-099323326900","D","0002940359","AG. NORTE","0.36","1,453.04"
10/10/2024,"001055","08100118-COSTO IVA CASH-PT-099323326900","D","0002940161","AG. NORTE","0.05","1,453.40"
10/10/2024,"001055","08100118-COSTO OPER CASH-PT-099323326900","D","0002940103","AG. NORTE","0.36","1,453.45"
10/10/2024,"001055","08099912-COSTO IVA CASH-PT-099323326900","D","0002939860","AG. NORTE","0.05","1,453.81"
10/10/2024,"001055","08099912-COSTO OPER CASH-PT-099323326900","D","0002939796","AG. NORTE","0.36","1,453.86"
10/10/2024,"001055","08099413-COSTO IVA CASH-PT-099323326900","D","0002934490","AG. NORTE","0.05","1,454.22"
10/10/2024,"001055","08099413-COSTO OPER CASH-PT-099323326900","D","0002934438","AG. NORTE","0.36","1,454.27"
10/10/2024,"001055","08098688-COSTO IVA CASH-PT-099323326900","D","0002934248","AG. NORTE","0.05","1,454.63"
10/10/2024,"001055","08098688-COSTO OPER CASH-PT-099323326900","D","0002934180","AG. NORTE","0.36","1,454.68"
10/10/2024,"001055","08098498-COSTO IVA CASH-PT-099323326900","D","0002933900","AG. NORTE","0.05","1,455.04"
10/10/2024,"001055","08098498-COSTO OPER CASH-PT-099323326900","D","0002936375","AG. NORTE","0.36","1,455.09"
10/10/2024,"001055","08098370-COSTO IVA CASH-PT-099323326900","D","0002933708","AG. NORTE","0.05","1,455.45"
10/10/2024,"001055","08098370-COSTO OPER CASH-PT-099323326900","D","0002933631","AG. NORTE","0.36","1,455.50"
10/10/2024,"001055","08097647-COSTO IVA CASH-PT-099323326900","D","0002935945","AG. NORTE","0.05","1,455.86"
10/10/2024,"001055","08097647-COSTO OPER CASH-PT-099323326900","D","0002933399","AG. NORTE","0.36","1,455.91"
10/10/2024,"001055","08097578-COSTO IVA CASH-PT-099323326900","D","0002935763","AG. NORTE","0.05","1,456.27"
10/10/2024,"001055","08097578-COSTO OPER CASH-PT-099323326900","D","0002935693","AG. NORTE","0.36","1,456.32"
10/10/2024,"001055","08097044-COSTO IVA CASH-PT-099323326900","D","0002932973","AG. NORTE","0.05","1,456.68"
10/10/2024,"001055","08097044-COSTO OPER CASH-PT-099323326900","D","0002932919","AG. NORTE","0.36","1,456.73"
10/10/2024,"001055","08085977-COSTO IVA CASH-PT-099323326900","D","0002932731","AG. NORTE","0.05","1,457.09"
10/10/2024,"001055","08085977-COSTO OPER CASH-PT-099323326900","D","0002932667","AG. NORTE","0.36","1,457.14"
10/10/2024,"001055","08085620-COSTO IVA CASH-PT-099323326900","D","0002934856","AG. NORTE","0.11","1,457.50"
10/10/2024,"001055","08085620-COSTO OPER CASH-PT-099323326900","D","0002932305","AG. NORTE","0.76","1,457.61"
10/10/2024,"001055","08084723-COSTO IVA CASH-PT-099323326900","D","0002929725","AG. NORTE","0.05","1,458.37"
10/10/2024,"001055","08084723-COSTO OPER CASH-PT-099323326900","D","0002932051","AG. NORTE","0.36","1,458.42"
09/10/2024,"001055","8101607-SINOBALSA SA-PT-L010 VERDESOTO","D","0058531346","AG. NORTE","1,280.00","1,458.78"
09/10/2024,"001055","8102425-SINOBALSA SA-PT-C009 PALOMEQUE","D","0058531279","AG. NORTE","2,114.00","2,738.78"
09/10/2024,"001055","8097647-SINOBALSA SA-PT-KIM DIF PRESTA","D","0058529966","AG. NORTE","25.80","4,852.78"
09/10/2024,"001055","8097578-SINOBALSA SA-PT-KIM DIF PRESTA","D","0058529799","AG. NORTE","218.80","4,878.58"
09/10/2024,"001055","8100856-SINOBALSA SA-PT-LUZ FACTURA 179","D","0058396765","AG. NORTE","5,824.53","5,097.38"
09/10/2024,"001055","8100316-SINOBALSA SA-PT-503 MEDINA JOSE","D","0058396740","AG. NORTE","2,787.77","10,921.91"
09/10/2024,"001055","8100402-SINOBALSA SA-PT-514 MEDINA JOSE","D","0058404035","AG. NORTE","1,781.39","13,709.68"
09/10/2024,"001055","8098370-SINOBALSA SA-PT-521 MOYAN FERNA","D","0058379557","AG. NORTE","2,743.63","15,491.07"
09/10/2024,"001055","8100118-SINOBALSA SA-PT-505 MEDINA JOSE","D","0058387172","AG. NORTE","2,634.16","18,234.70"
09/10/2024,"001055","8098498-SINOBALSA SA-PT-523 CAIZA JEYSO","D","0058379367","AG. NORTE","3,298.93","20,868.86"
09/10/2024,"001055","8099413-SINOBALSA SA-PT-519 GUAMAN MEDA","D","0058379140","AG. NORTE","1,867.05","24,167.79"
09/10/2024,"001055","8099912-SINOBALSA SA-PT-518 MEDINA JOSE","D","0058379030","AG. NORTE","2,364.02","26,034.84"
09/10/2024,"001055","8098688-SINOBALSA SA-PT-520 LOPEZ DANNY","D","0058379010","AG. NORTE","1,419.11","28,398.86"
09/10/2024,"001055","8097044-SINOBALSA SA-PT-479 morales ANG","D","0058378742","AG. NORTE","2,626.86","29,817.97"
09/10/2024,"001330","08085620-SINOBALSA SA        -522 CASTRO F2","D","0051011634","LA PIAZZA","1,900.00","32,444.83"
09/10/2024,"001055","8085977-SINOBALSA SA-PT-DIFERENCIA POZO","D","0037082594","AG. NORTE","500.00","34,344.83"
09/10/2024,"001055","8084723-SINOBALSA SA-PT-516 MORALES ANG","D","0021789744","AG. NORTE","192.98","34,844.83"
09/10/2024,"001055","08056066-COSTO IVA CASH-PT-099323326900","D","0002885513","AG. NORTE","0.05","35,037.81"
09/10/2024,"001055","08056066-COSTO OPER CASH-PT-099323326900","D","0002887595","AG. NORTE","0.36","35,037.86"
09/10/2024,"001055","08055894-COSTO IVA CASH-PT-099323326900","D","0002885334","AG. NORTE","0.05","35,038.22"
09/10/2024,"001055","08055894-COSTO OPER CASH-PT-099323326900","D","0002885287","AG. NORTE","0.36","35,038.27"
09/10/2024,"001055","08048759-COSTO IVA CASH-PT-099323326900","D","0002887248","AG. NORTE","0.05","35,038.63"
09/10/2024,"001055","08048759-COSTO OPER CASH-PT-099323326900","D","0002885085","AG. NORTE","0.36","35,038.68"
09/10/2024,"001055","08047952-COSTO IVA CASH-PT-099323326900","D","0002884909","AG. NORTE","0.05","35,039.04"
09/10/2024,"001055","08047952-COSTO OPER CASH-PT-099323326900","D","0002886991","AG. NORTE","0.36","35,039.09"
09/10/2024,"001055","08062271-COSTO IVA CASH-PT-099323326900","D","0002886842","AG. NORTE","0.05","35,039.45"
09/10/2024,"001055","08062271-COSTO OPER CASH-PT-099323326900","D","0002886795","AG. NORTE","0.36","35,039.50"
09/10/2024,"001055","08062186-COSTO IVA CASH-PT-099323326900","D","0002886656","AG. NORTE","0.05","35,039.86"
09/10/2024,"001055","08062186-COSTO OPER CASH-PT-099323326900","D","0002886615","AG. NORTE","0.36","35,039.91"
09/10/2024,"001055","08062109-COSTO IVA CASH-PT-099323326900","D","0002886370","AG. NORTE","0.05","35,040.27"
09/10/2024,"001055","08062109-COSTO OPER CASH-PT-099323326900","D","0002886312","AG. NORTE","0.36","35,040.32"
09/10/2024,"001055","08061998-COSTO IVA CASH-PT-099323326900","D","0002883911","AG. NORTE","0.05","35,040.68"
09/10/2024,"001055","08061998-COSTO OPER CASH-PT-099323326900","D","0002883849","AG. NORTE","0.36","35,040.73"
09/10/2024,"001055","08061758-COSTO IVA CASH-PT-099323326900","D","0002883705","AG. NORTE","0.05","35,041.09"
09/10/2024,"001055","08061758-COSTO OPER CASH-PT-099323326900","D","0002883650","AG. NORTE","0.36","35,041.14"
09/10/2024,"001055","08061432-COSTO IVA CASH-PT-099323326900","D","0002883475","AG. NORTE","0.05","35,041.50"
09/10/2024,"001055","08061432-COSTO OPER CASH-PT-099323326900","D","0002881301","AG. NORTE","0.36","35,041.55"
09/10/2024,"001055","08061250-COSTO IVA CASH-PT-099323326900","D","0002883233","AG. NORTE","0.05","35,041.91"
09/10/2024,"001055","08061250-COSTO OPER CASH-PT-099323326900","D","0002881095","AG. NORTE","0.36","35,041.96"
09/10/2024,"001055","08061136-COSTO IVA CASH-PT-099323326900","D","0002880907","AG. NORTE","0.05","35,042.32"
09/10/2024,"001055","08061136-COSTO OPER CASH-PT-099323326900","D","0002882964","AG. NORTE","0.36","35,042.37"
09/10/2024,"001055","08059186-COSTO IVA CASH-PT-099323326900","D","0002882812","AG. NORTE","0.05","35,042.73"
09/10/2024,"001055","08059186-COSTO OPER CASH-PT-099323326900","D","0002880662","AG. NORTE","0.36","35,042.78"
09/10/2024,"001055","08058412-COSTO IVA CASH-PT-099323326900","D","0002882640","AG. NORTE","0.05","35,043.14"
09/10/2024,"001055","08058412-COSTO OPER CASH-PT-099323326900","D","0002882593","AG. NORTE","0.36","35,043.19"
09/10/2024,"001055","08057487-COSTO IVA CASH-PT-099323326900","D","0002882452","AG. NORTE","0.05","35,043.55"
09/10/2024,"001055","08057487-COSTO OPER CASH-PT-099323326900","D","0002882403","AG. NORTE","0.36","35,043.60"
09/10/2024,"001055","08057090-COSTO IVA CASH-PT-099323326900","D","0002880142","AG. NORTE","0.05","35,043.96"
09/10/2024,"001055","08057090-COSTO OPER CASH-PT-099323326900","D","0002882139","AG. NORTE","0.36","35,044.01"
09/10/2024,"001055","08056641-COSTO IVA CASH-PT-099323326900","D","0002881865","AG. NORTE","0.05","35,044.37"
09/10/2024,"001055","08056641-COSTO OPER CASH-PT-099323326900","D","0002879692","AG. NORTE","0.36","35,044.42"
09/10/2024,"001055","08056286-COSTO IVA CASH-PT-099323326900","D","0002879515","AG. NORTE","0.05","35,044.78"
09/10/2024,"001055","08056286-COSTO OPER CASH-PT-099323326900","D","0002879474","AG. NORTE","0.36","35,044.83"
08/10/2024,"001045","8062271-SINOBALSA SA-PT-514 MEDINA JOSE","C","0057876980","AG. NORTE","1,781.39","35,045.19"
08/10/2024,"001045","8061998-SINOBALSA SA-PT-503 MEDINA JOSE","C","0057876552","AG. NORTE","2,778.00","33,263.80"
08/10/2024,"001045","8062109-SINOBALSA SA-PT-505 MEDINA JOSE","C","0057876074","AG. NORTE","2,634.16","30,485.80"
08/10/2024,"001045","8061758-SINOBALSA SA-PT-518 MEDINA JOSE","C","0057865903","AG. NORTE","2,364.02","27,851.64"
08/10/2024,"001055","8061432-SINOBALSA SA-PT-513 VERA PABLO","D","0051090424","AG. NORTE","2,359.17","25,487.62"
08/10/2024,"001055","8062271-SINOBALSA SA-PT-514 MEDINA JOSE","D","0051083489","AG. NORTE","1,781.39","27,846.79"
08/10/2024,"001055","8061758-SINOBALSA SA-PT-518 MEDINA JOSE","D","0051089311","AG. NORTE","2,364.02","29,628.18"
08/10/2024,"001045","08062742-CONDOREXPLOTAR-PT-099323326900","C","0049345541","AG. NORTE","30,000.00","31,992.20"
08/10/2024,"001055","8062109-SINOBALSA SA-PT-505 MEDINA JOSE","D","0048054506","AG. NORTE","2,634.16","1,992.20"
08/10/2024,"001055","8061998-SINOBALSA SA-PT-503 MEDINA JOSE","D","0048054310","AG. NORTE","2,778.00","4,626.36"
08/10/2024,"001055","8061136-SINOBALSA SA-PT-506 ESTRADA KAT","D","0048054253","AG. NORTE","1,832.30","7,404.36"
08/10/2024,"001055","8062186-SINOBALSA SA-PT-512 GUALPA JAIR","D","0048053621","AG. NORTE","5,545.67","9,236.66"
08/10/2024,"001055","8061250-SINOBALSA SA-PT-504 MORALES ANG","D","0048046419","AG. NORTE","2,303.92","14,782.33"
08/10/2024,"001055","8059186-SINOBALSA SA-PT-498 BENAVIDES J","D","0039230276","AG. NORTE","2,493.66","17,086.25"
08/10/2024,"001055","8058412-SINOBALSA SA-PT-TRANSP 2X40 F10","D","0039230231","AG. NORTE","440.00","19,579.91"
08/10/2024,"001055","8056641-SINOBALSA SA-PT-504 MORALES ANG","D","0039236097","AG. NORTE","2,303.92","20,019.91"
08/10/2024,"001055","8057487-SINOBALSA SA-PT-501 MORALALES A","D","0039230258","AG. NORTE","2,278.39","22,323.83"
08/10/2024,"001055","8055894-SINOBALSA SA-PT-492 BENAVIDES J","D","0039235919","AG. NORTE","2,390.58","24,602.22"
08/10/2024,"001055","8056066-SINOBALSA SA-PT-494 GUALPA JAIR","D","0039235383","AG. NORTE","5,255.56","26,992.80"
08/10/2024,"001055","8056286-SINOBALSA SA-PT-497 MORALES ANG","D","0039235353","AG. NORTE","2,342.52","32,248.36"
08/10/2024,"001055","8057090-SINOBALSA SA-PT-487 GUJILAN JOS","D","0039235256","AG. NORTE","1,960.73","34,590.88"
08/10/2024,"001055","8048759-SINOBALSA SA-PT-DEV LOPEZ TANIA","D","0039229271","AG. NORTE","566.20","36,551.61"
08/10/2024,"001055","8047952-SINOBALSA SA-PT-ANT TECNI POZO","D","0039234447","AG. NORTE","400.00","37,117.81"
07/10/2024,"001055","07979359-COSTO IVA CASH-PT-099323326900","D","0001777192","AG. NORTE","0.05","37,517.81"
07/10/2024,"001055","07979359-COSTO OPER CASH-PT-099323326900","D","0001777155","AG. NORTE","0.36","37,517.86"
07/10/2024,"001055","07979133-COSTO IVA CASH-PT-099323326900","D","0001775976","AG. NORTE","0.05","37,518.22"
07/10/2024,"001055","07979133-COSTO OPER CASH-PT-099323326900","D","0001776018","AG. NORTE","0.36","37,518.27"
07/10/2024,"001055","07969959-COSTO IVA CASH-PT-099323326900","D","0001774855","AG. NORTE","0.05","37,518.63"
07/10/2024,"001055","07969959-COSTO OPER CASH-PT-099323326900","D","0001775718","AG. NORTE","0.36","37,518.68"
07/10/2024,"001055","07968266-COSTO IVA CASH-PT-099323326900","D","0001775515","AG. NORTE","0.05","37,519.04"
07/10/2024,"001055","07968266-COSTO OPER CASH-PT-099323326900","D","0001774549","AG. NORTE","0.36","37,519.09"
07/10/2024,"001055","07968147-COSTO IVA CASH-PT-099323326900","D","0001774370","AG. NORTE","0.32","37,519.45"
07/10/2024,"001055","07968147-COSTO OPER CASH-PT-099323326900","D","0001774334","AG. NORTE","2.14","37,519.77"
07/10/2024,"001055","07968147-COSTO IVA CASH-PT-099323326900","D","0001775105","AG. NORTE","0.05","37,521.91"
07/10/2024,"001055","07968147-COSTO OPER CASH-PT-099323326900","D","0001775036","AG. NORTE","0.36","37,521.96"
07/10/2024,"001055","07961731-COSTO IVA CASH-PT-099323326900","D","0001773874","AG. NORTE","0.05","37,522.32"
07/10/2024,"001055","07961731-COSTO OPER CASH-PT-099323326900","D","0001772898","AG. NORTE","0.36","37,522.37"
07/10/2024,"001055","07961652-COSTO IVA CASH-PT-099323326900","D","0001772730","AG. NORTE","0.05","37,522.73"
07/10/2024,"001055","07961652-COSTO OPER CASH-PT-099323326900","D","0001773613","AG. NORTE","0.36","37,522.78"
07/10/2024,"001055","07961573-COSTO IVA CASH-PT-099323326900","D","0001773411","AG. NORTE","0.05","37,523.14"
07/10/2024,"001055","07961573-COSTO OPER CASH-PT-099323326900","D","0001773375","AG. NORTE","0.36","37,523.19"
07/10/2024,"001055","07961511-COSTO IVA CASH-PT-099323326900","D","0001773192","AG. NORTE","0.05","37,523.55"
07/10/2024,"001055","07961511-COSTO OPER CASH-PT-099323326900","D","0001773139","AG. NORTE","0.36","37,523.60"
07/10/2024,"001055","07961417-COSTO IVA CASH-PT-099323326900","D","0001771970","AG. NORTE","0.05","37,523.96"
07/10/2024,"001055","07961417-COSTO OPER CASH-PT-099323326900","D","0001771924","AG. NORTE","0.36","37,524.01"
07/10/2024,"001055","07961339-COSTO IVA CASH-PT-099323326900","D","0001771716","AG. NORTE","0.05","37,524.37"
07/10/2024,"001055","07961339-COSTO OPER CASH-PT-099323326900","D","0001771654","AG. NORTE","0.36","37,524.42"
07/10/2024,"001055","07960013-COSTO IVA CASH-PT-099323326900","D","0001771485","AG. NORTE","0.11","37,524.78"
07/10/2024,"001055","07960013-COSTO OPER CASH-PT-099323326900","D","0001770514","AG. NORTE","0.76","37,524.89"
07/10/2024,"001055","07959786-COSTO IVA CASH-PT-099323326900","D","0001771280","AG. NORTE","0.11","37,525.65"
07/10/2024,"001055","07959786-COSTO OPER CASH-PT-099323326900","D","0001771225","AG. NORTE","0.76","37,525.76"
07/10/2024,"001055","07948984-COSTO IVA CASH-PT-099323326900","D","0001771067","AG. NORTE","0.05","37,526.52"
07/10/2024,"001055","07948984-COSTO OPER CASH-PT-099323326900","D","0001771010","AG. NORTE","0.36","37,526.57"
07/10/2024,"001055","07948574-COSTO IVA CASH-PT-099323326900","D","0001769815","AG. NORTE","0.05","37,526.93"
07/10/2024,"001055","07948574-COSTO OPER CASH-PT-099323326900","D","0001768826","AG. NORTE","0.36","37,526.98"
04/10/2024,"001045","7968147-SINOBALSA SA-PT-ROL SEPT 2DO","C","0074829074","AG. NORTE","566.20","37,527.34"
04/10/2024,"001055","7978784-SINOBALSA SA-PT-460 MEDINA JOSE","D","0071007056","AG. NORTE","1,986.21","36,961.14"
04/10/2024,"001055","7979359-SINOBALSA SA-PT-493 BENAVIDES J","D","0071006715","AG. NORTE","2,033.82","38,947.35"
04/10/2024,"001055","7979133-SINOBALSA SA-PT-484 LOPEZ DANNY","D","0071005431","AG. NORTE","966.59","40,981.17"
04/10/2024,"001055","7968147-SINOBALSA SA-PT-ROL SEPT 2DO","D","0071004706","AG. NORTE","2,450.60","41,947.76"
04/10/2024,"001055","7969959-SINOBALSA SA-PT-476 ESTRADA KAT","D","0071004259","AG. NORTE","1,570.14","44,398.36"
04/10/2024,"001055","7968266-SINOBALSA SA-PT-SERV PREST FABR","D","0071002565","AG. NORTE","995.00","45,968.50"
04/10/2024,"001330","07960013-SINOBALSA SA        -511 CASTRO","D","0054594638","LA PIAZZA","328.44","46,963.50"
04/10/2024,"001330","07959786-SINOBALSA SA        -511 CASTRO F01","D","0054485543","LA PIAZZA","1,900.00","47,291.94"
04/10/2024,"001055","7961573-SINOBALSA SA-PT-489 CUJILAN JOS","D","0040463440","AG. NORTE","1,634.96","49,191.94"
04/10/2024,"001055","7961731-SINOBALSA SA-PT-458 LOPEZ DANNY","D","0040463439","AG. NORTE","1,079.30","50,826.90"
04/10/2024,"001055","7961652-SINOBALSA SA-PT-495 lopez danny","D","0040459875","AG. NORTE","1,097.97","51,906.20"
04/10/2024,"001055","7961511-SINOBALSA SA-PT-488 CUJILAN JOS","D","0040459741","AG. NORTE","2,528.24","53,004.17"
04/10/2024,"001055","7961417-SINOBALSA SA-PT-483 CUJILAN JOS","D","0040458466","AG. NORTE","2,228.79","55,532.41"
04/10/2024,"001055","7961339-SINOBALSA SA-PT-482 cujilan jos","D","0040457357","AG. NORTE","2,420.49","57,761.20"
04/10/2024,"001055","7948574-SINOBALSA SA-PT-PORTEO TPG 2X40","D","0023123140","AG. NORTE","262.81","60,181.69"
04/10/2024,"001055","7948984-SINOBALSA SA-PT-INTERQUIMIEC","D","0023122475","AG. NORTE","2,517.35","60,444.50"
04/10/2024,"001055","07905294-COSTO IVA CASH-PT-099323326900","D","0002947217","AG. NORTE","0.05","62,961.85"
04/10/2024,"001055","07905294-COSTO OPER CASH-PT-099323326900","D","0002947133","AG. NORTE","0.36","62,961.90"
04/10/2024,"001055","07905268-COSTO IVA CASH-PT-099323326900","D","0002945816","AG. NORTE","0.05","62,962.26"
04/10/2024,"001055","07905268-COSTO OPER CASH-PT-099323326900","D","0002945751","AG. NORTE","0.36","62,962.31"
04/10/2024,"001055","07905256-COSTO IVA CASH-PT-099323326900","D","0002945537","AG. NORTE","0.05","62,962.67"
04/10/2024,"001055","07905256-COSTO OPER CASH-PT-099323326900","D","0002944571","AG. NORTE","0.36","62,962.72"
04/10/2024,"001055","07905252-COSTO IVA CASH-PT-099323326900","D","0002944384","AG. NORTE","0.05","62,963.08"
04/10/2024,"001055","07905252-COSTO OPER CASH-PT-099323326900","D","0002945247","AG. NORTE","0.36","62,963.13"
04/10/2024,"001055","07904320-COSTO IVA CASH-PT-099323326900","D","0002945052","AG. NORTE","0.05","62,963.49"
04/10/2024,"001055","07904320-COSTO OPER CASH-PT-099323326900","D","0002943982","AG. NORTE","0.36","62,963.54"
04/10/2024,"001055","07903961-COSTO IVA CASH-PT-099323326900","D","0002942935","AG. NORTE","1.39","62,963.90"
04/10/2024,"001055","07903961-COSTO OPER CASH-PT-099323326900","D","0002942853","AG. NORTE","9.27","62,965.29"
04/10/2024,"001055","07903961-COSTO IVA CASH-PT-099323326900","D","0002943596","AG. NORTE","0.37","62,974.56"
04/10/2024,"001055","07903961-COSTO OPER CASH-PT-099323326900","D","0002943541","AG. NORTE","2.50","62,974.93"
04/10/2024,"001055","07899511-COSTO IVA CASH-PT-099323326900","D","0002943275","AG. NORTE","0.05","62,977.43"
04/10/2024,"001055","07899511-COSTO OPER CASH-PT-099323326900","D","0002942311","AG. NORTE","0.36","62,977.48"
03/10/2024,"001055","7905252-SINOBALSA SA-PT-507 BENAVIDES J","D","0008094067","AG. NORTE","2,271.55","62,977.84"
03/10/2024,"001055","7905268-SINOBALSA SA-PT-510 LOPEZ DANNY","D","0008081406","AG. NORTE","1,133.07","65,249.39"
03/10/2024,"001055","7905256-SINOBALSA SA-PT-509 LOPEZ DANNY","D","0008080873","AG. NORTE","1,182.17","66,382.46"
03/10/2024,"001055","7905294-SINOBALSA SA-PT-500 MOYAN FERNA","D","0008080631","AG. NORTE","2,513.30","67,564.63"
03/10/2024,"001055","07687157-COSTO IVA CASH-PT-099323326900","D","0003020531","AG. NORTE","0.05","70,077.93"
03/10/2024,"001055","07687157-COSTO OPER CASH-PT-099323326900","D","0003020373","AG. NORTE","0.36","70,077.98"
03/10/2024,"001055","07671806-COSTO IVA CASH-PT-099323326900","D","0003020182","AG. NORTE","0.05","70,078.34"
03/10/2024,"001055","07671806-COSTO OPER CASH-PT-099323326900","D","0003020129","AG. NORTE","0.36","70,078.39"
03/10/2024,"001055","07671609-COSTO IVA CASH-PT-099323326900","D","0003019316","AG. NORTE","0.05","70,078.75"
03/10/2024,"001055","07671609-COSTO OPER CASH-PT-099323326900","D","0003019265","AG. NORTE","0.36","70,078.80"
03/10/2024,"001055","7904320-SINOBALSA SA-PT-490 CAYZA JEYSO","D","0001260329","AG. NORTE","3,467.24","70,079.16"
03/10/2024,"001055","7903961-SINOBALSA SA-PT-ROL SEPT30","D","0001253145","AG. NORTE","8,842.80","73,546.40"
02/10/2024,"001055","7899511-SINOBALSA SA-PT-TERCON TURNOS 2","D","0072431371","AG. NORTE","90.42","82,389.20"
02/10/2024,"001055","7687157-SINOBALSA SA-PT-485 BENAVIDES J","D","0001067446","AG. NORTE","2,288.26","82,479.62"
02/10/2024,"001055","7671609-SINOBALSA SA-PT-491 GUJILAN JOS","D","0001067423","AG. NORTE","2,481.05","84,767.88"
02/10/2024,"001055","7671806-SINOBALSA SA-PT-496 GUJILAN JOS","D","0001068181","AG. NORTE","2,402.27","87,248.93"
01/10/2024,"001055","07752084-COSTO IVA CASH-PT-099323326900","D","0006478844","AG. NORTE","0.05","89,651.20"
01/10/2024,"001055","07752084-COSTO OPER CASH-PT-099323326900","D","0006479399","AG. NORTE","0.36","89,651.25"
